Away_Team,Home_Team,Date,Ref_Crew,Accepted_Count,Yards,Away_Count,Away_Yards,Home_Count,Home_Yards,Total_Flags,Week,Year
Tennessee,Pittsburgh,09/10/2009,Bill Leavy,11,88,5,28,6,60,13,1,2009
Miami,Atlanta,09/13/2009,Walt Coleman,8,62,4,27,4,35,11,1,2009
Kansas City,Baltimore,09/13/2009,Gene Steratore,11,80,3,15,8,65,14,1,2009
Philadelphia,Carolina,09/13/2009,Jeff Triplette,14,106,9,76,5,30,14,1,2009
Denver,Cincinnati,09/13/2009,Jerome Boger,10,66,6,39,4,27,12,1,2009
Minnesota,Cleveland,09/13/2009,John Parry,11,104,3,38,8,66,12,1,2009
N.Y. Jets,Houston,09/13/2009,Ed Hochuli,16,117,10,80,6,37,19,1,2009
Jacksonville,Indianapolis,09/13/2009,Tony Corrente,6,41,3,24,3,17,6,1,2009
Detroit,New Orleans,09/13/2009,Mike Carey,15,116,8,80,7,36,17,1,2009
Dallas,Tampa Bay,09/13/2009,Al Riveron,7,56,4,41,3,15,9,1,2009
San Francisco,Arizona,09/13/2009,Don Carey,16,113,4,31,12,82,16,1,2009
Washington,N.Y. Giants,09/13/2009,Terry McAulay,8,62,4,32,4,30,12,1,2009
St. Louis,Seattle,09/13/2009,Pete Morelli,14,110,10,85,4,25,15,1,2009
Chicago,Green Bay,09/13/2009,Ron Winter,9,70,3,25,6,45,9,1,2009
Buffalo,New England,09/14/2009,Scott Green,15,126,9,71,6,55,16,1,2009
San Diego,Oakland,09/14/2009,Carl Cheffers,15,100,9,60,6,40,15,1,2009
Carolina,Atlanta,09/20/2009,Don Carey,12,75,6,35,6,40,14,2,2009
Minnesota,Detroit,09/20/2009,Carl Cheffers,11,88,5,43,6,45,12,2,2009
Cincinnati,Green Bay,09/20/2009,Ed Hochuli,24,176,13,100,11,76,27,2,2009
Arizona,Jacksonville,09/20/2009,Gene Steratore,15,108,7,58,8,50,15,2,2009
Oakland,Kansas City,09/20/2009,Walt Anderson,16,115,7,45,9,70,18,2,2009
New England,N.Y. Jets,09/20/2009,John Parry,19,144,11,89,8,55,21,2,2009
New Orleans,Philadelphia,09/20/2009,Al Riveron,10,58,3,13,7,45,16,2,2009
Houston,Tennessee,09/20/2009,Walt Coleman,14,104,6,40,8,64,23,2,2009
St. Louis,Washington,09/20/2009,Jerome Boger,11,80,6,45,5,35,13,2,2009
Tampa Bay,Buffalo,09/20/2009,Ron Winter,20,167,13,112,7,55,24,2,2009
Seattle,San Francisco,09/20/2009,Bill Leavy,12,99,6,45,6,54,13,2,2009
Pittsburgh,Chicago,09/20/2009,Scott Green,16,132,6,52,10,80,17,2,2009
Cleveland,Denver,09/20/2009,Pete Morelli,9,93,4,43,5,50,9,2,2009
Baltimore,San Diego,09/20/2009,Tony Corrente,16,117,4,32,12,85,18,2,2009
N.Y. Giants,Dallas,09/20/2009,Mike Carey,8,90,4,40,4,50,9,2,2009
Indianapolis,Miami,09/21/2009,Terry McAulay,8,40,4,20,4,20,10,2,2009
Cleveland,Baltimore,09/27/2009,Terry McAulay,13,130,5,46,8,84,19,3,2009
Pittsburgh,Cincinnati,09/27/2009,Gene Steratore,9,81,5,51,4,30,11,3,2009
Washington,Detroit,09/27/2009,Scott Green,17,155,9,97,8,58,17,3,2009
Jacksonville,Houston,09/27/2009,Ron Winter,10,100,5,40,5,60,11,3,2009
San Francisco,Minnesota,09/27/2009,Jerome Boger,16,112,7,60,9,52,18,3,2009
Atlanta,New England,09/27/2009,Al Riveron,9,64,7,54,2,10,9,3,2009
Kansas City,Philadelphia,09/27/2009,John Parry,13,110,10,90,3,20,14,3,2009
Green Bay,St. Louis,09/27/2009,Walt Coleman,12,91,6,51,6,40,14,3,2009
N.Y. Giants,Tampa Bay,09/27/2009,Jeff Triplette,10,85,5,60,5,25,12,3,2009
New Orleans,Buffalo,09/27/2009,Walt Anderson,21,213,9,97,12,116,23,3,2009
Chicago,Seattle,09/27/2009,Don Carey,11,105,7,60,4,45,12,3,2009
Tennessee,N.Y. Jets,09/27/2009,Mike Carey,6,40,3,15,3,25,6,3,2009
Denver,Oakland,09/27/2009,Ed Hochuli,11,83,5,30,6,53,15,3,2009
Miami,San Diego,09/27/2009,Bill Leavy,10,59,7,39,3,20,10,3,2009
Indianapolis,Arizona,09/27/2009,Pete Morelli,12,104,7,69,5,35,15,3,2009
Carolina,Dallas,09/28/2009,Tony Corrente,15,140,6,60,9,80,15,3,2009
Detroit,Chicago,10/04/2009,Walt Coleman,10,87,7,51,3,36,13,4,2009
Cincinnati,Cleveland,10/04/2009,Scott Green,11,90,6,46,5,44,15,4,2009
Oakland,Houston,10/04/2009,Don Carey,10,65,9,60,1,5,13,4,2009
Seattle,Indianapolis,10/04/2009,Mike Carey,13,93,6,45,7,48,14,4,2009
Tennessee,Jacksonville,10/04/2009,Al Riveron,10,98,6,68,4,30,11,4,2009
N.Y. Giants,Kansas City,10/04/2009,Jerome Boger,15,109,8,54,7,55,21,4,2009
Baltimore,New England,10/04/2009,Ron Winter,14,126,9,85,5,41,18,4,2009
Tampa Bay,Washington,10/04/2009,Ed Hochuli,9,80,5,40,4,40,10,4,2009
Buffalo,Miami,10/04/2009,Carl Cheffers,8,64,3,19,5,45,9,4,2009
N.Y. Jets,New Orleans,10/04/2009,Bill Leavy,10,91,3,21,7,70,10,4,2009
Dallas,Denver,10/04/2009,Walt Anderson,17,151,7,70,10,81,18,4,2009
St. Louis,San Francisco,10/04/2009,Tony Corrente,13,106,10,73,3,33,15,4,2009
San Diego,Pittsburgh,10/04/2009,Jeff Triplette,9,79,3,20,6,59,11,4,2009
Green Bay,Minnesota,10/05/2009,Gene Steratore,9,67,7,57,2,10,12,4,2009
Cincinnati,Baltimore,10/11/2009,Jeff Triplette,17,115,7,39,10,76,19,5,2009
Cleveland,Buffalo,10/11/2009,Jerome Boger,16,104,3,29,13,75,19,5,2009
Washington,Carolina,10/11/2009,Walt Coleman,9,47,4,20,5,27,11,5,2009
Pittsburgh,Detroit,10/11/2009,Ed Hochuli,12,125,6,59,6,66,15,5,2009
Dallas,Kansas City,10/11/2009,Ron Winter,20,140,13,90,7,50,23,5,2009
Oakland,N.Y. Giants,10/11/2009,John Parry,11,104,7,67,4,37,12,5,2009
Tampa Bay,Philadelphia,10/11/2009,Terry McAulay,14,141,4,30,10,111,17,5,2009
Minnesota,St. Louis,10/11/2009,Don Carey,12,126,5,44,7,82,14,5,2009
Atlanta,San Francisco,10/11/2009,Pete Morelli,16,182,8,90,8,92,20,5,2009
Houston,Arizona,10/11/2009,Tony Corrente,13,93,6,53,7,40,13,5,2009
New England,Denver,10/11/2009,Carl Cheffers,7,66,4,46,3,20,13,5,2009
Jacksonville,Seattle,10/11/2009,Scott Green,10,83,9,73,1,10,13,5,2009
Indianapolis,Tennessee,10/11/2009,Walt Anderson,16,137,7,48,9,89,19,5,2009
N.Y. Jets,Miami,10/12/2009,Al Riveron,14,168,6,56,8,112,15,5,2009
Houston,Cincinnati,10/18/2009,Bill Leavy,11,105,7,60,4,45,16,6,2009
Detroit,Green Bay,10/18/2009,Jerome Boger,19,170,6,40,13,130,22,6,2009
St. Louis,Jacksonville,10/18/2009,Jeff Triplette,8,62,6,52,2,10,8,6,2009
Baltimore,Minnesota,10/18/2009,Mike Carey,9,89,6,74,3,15,15,6,2009
N.Y. Giants,New Orleans,10/18/2009,Ed Hochuli,15,165,9,110,6,55,17,6,2009
Cleveland,Pittsburgh,10/18/2009,Walt Anderson,8,75,4,45,4,30,9,6,2009
Carolina,Tampa Bay,10/18/2009,John Parry,8,70,3,30,5,40,10,6,2009
Kansas City,Washington,10/18/2009,Tony Corrente,11,93,4,30,7,63,11,6,2009
Philadelphia,Oakland,10/18/2009,Pete Morelli,7,61,4,38,3,23,10,6,2009
Arizona,Seattle,10/18/2009,Carl Cheffers,13,132,7,76,6,56,14,6,2009
Tennessee,New England,10/18/2009,Gene Steratore,12,95,6,55,6,40,12,6,2009
Buffalo,N.Y. Jets,10/18/2009,Walt Coleman,22,160,8,64,14,96,27,6,2009
Chicago,Atlanta,10/18/2009,Terry McAulay,15,135,9,65,6,70,17,6,2009
Denver,San Diego,10/19/2009,Scott Green,8,92,4,48,4,44,13,6,2009
Chicago,Cincinnati,10/25/2009,Walt Anderson,9,64,6,44,3,20,11,7,2009
Green Bay,Cleveland,10/25/2009,Don Carey,13,110,8,70,5,40,13,7,2009
San Francisco,Houston,10/25/2009,Mike Carey,18,142,11,65,7,77,22,7,2009
San Diego,Kansas City,10/25/2009,Pete Morelli,16,100,9,59,7,41,16,7,2009
Minnesota,Pittsburgh,10/25/2009,Ron Winter,14,93,11,78,3,15,16,7,2009
Indianapolis,St. Louis,10/25/2009,Carl Cheffers,11,124,6,51,5,73,11,7,2009
New England,Tampa Bay,10/25/2009,Jerome Boger,16,121,10,66,6,55,18,7,2009
Buffalo,Carolina,10/25/2009,Terry McAulay,12,89,3,22,9,67,14,7,2009
N.Y. Jets,Oakland,10/25/2009,Gene Steratore,5,32,2,8,3,24,7,7,2009
Atlanta,Dallas,10/25/2009,Scott Green,11,80,3,30,8,50,15,7,2009
New Orleans,Miami,10/25/2009,John Parry,14,80,6,25,8,55,16,7,2009
Arizona,N.Y. Giants,10/25/2009,Al Riveron,14,90,7,60,7,30,14,7,2009
Philadelphia,Washington,10/26/2009,Bill Leavy,18,126,12,66,6,60,19,7,2009
Denver,Baltimore,11/01/2009,Walt Coleman,14,129,6,35,8,94,14,8,2009
Houston,Buffalo,11/01/2009,Gene Steratore,9,81,5,45,4,36,9,8,2009
Cleveland,Chicago,11/01/2009,Al Riveron,8,65,3,30,5,35,8,8,2009
Seattle,Dallas,11/01/2009,Jerome Boger,11,96,6,53,5,43,11,8,2009
St. Louis,Detroit,11/01/2009,Ron Winter,13,94,5,27,8,67,17,8,2009
Minnesota,Green Bay,11/01/2009,Tony Corrente,9,74,3,29,6,45,13,8,2009
San Francisco,Indianapolis,11/01/2009,Ed Hochuli,12,88,7,50,5,38,12,8,2009
Miami,N.Y. Jets,11/01/2009,Don Carey,10,65,4,25,6,40,11,8,2009
Oakland,San Diego,11/01/2009,Terry McAulay,11,71,6,31,5,40,12,8,2009
Jacksonville,Tennessee,11/01/2009,Pete Morelli,6,47,2,27,4,20,9,8,2009
Carolina,Arizona,11/01/2009,Mike Carey,12,107,7,72,5,35,14,8,2009
N.Y. Giants,Philadelphia,11/01/2009,Carl Cheffers,9,70,4,25,5,45,14,8,2009
Atlanta,New Orleans,11/02/2009,Jeff Triplette,11,90,4,25,7,65,13,8,2009
Washington,Atlanta,11/08/2009,Ron Winter,17,142,10,88,7,54,19,9,2009
Arizona,Chicago,11/08/2009,Ed Hochuli,11,104,2,15,9,89,12,9,2009
Baltimore,Cincinnati,11/08/2009,Al Riveron,13,120,7,80,6,40,15,9,2009
Houston,Indianapolis,11/08/2009,Jeff Triplette,17,143,13,103,4,40,22,9,2009
Kansas City,Jacksonville,11/08/2009,Bill Leavy,6,41,1,10,5,31,8,9,2009
Miami,New England,11/08/2009,Mike Carey,8,84,3,35,5,49,13,9,2009
Green Bay,Tampa Bay,11/08/2009,Pete Morelli,7,50,5,35,2,15,9,9,2009
Carolina,New Orleans,11/08/2009,Scott Green,13,92,6,37,7,55,14,9,2009
Detroit,Seattle,11/08/2009,John Parry,15,122,9,77,6,45,18,9,2009
San Diego,N.Y. Giants,11/08/2009,Walt Anderson,12,124,3,20,9,104,17,9,2009
Tennessee,San Francisco,11/08/2009,Carl Cheffers,13,83,8,58,5,25,16,9,2009
Dallas,Philadelphia,11/08/2009,Walt Coleman,19,152,11,70,8,82,19,9,2009
Pittsburgh,Denver,11/09/2009,Don Carey,7,53,4,28,3,25,8,9,2009
Chicago,San Francisco,11/12/2009,Ron Winter,19,152,10,75,9,77,24,10,2009
Atlanta,Carolina,11/15/2009,Bill Leavy,9,74,4,26,5,48,12,10,2009
Tampa Bay,Miami,11/15/2009,Tony Corrente,12,107,9,77,3,30,14,10,2009
Detroit,Minnesota,11/15/2009,Walt Anderson,17,131,4,40,13,91,21,10,2009
Jacksonville,N.Y. Jets,11/15/2009,Ed Hochuli,9,66,5,40,4,26,10,10,2009
Cincinnati,Pittsburgh,11/15/2009,Terry McAulay,12,137,7,87,5,50,13,10,2009
New Orleans,St. Louis,11/15/2009,Gene Steratore,10,60,6,40,4,20,12,10,2009
Buffalo,Tennessee,11/15/2009,John Parry,18,140,10,65,8,75,22,10,2009
Denver,Washington,11/15/2009,Pete Morelli,6,64,4,45,2,19,8,10,2009
Kansas City,Oakland,11/15/2009,Mike Carey,15,123,5,35,10,88,19,10,2009
Seattle,Arizona,11/15/2009,Walt Coleman,20,249,9,113,11,136,26,10,2009
Dallas,Green Bay,11/15/2009,Jeff Triplette,22,167,10,67,12,100,27,10,2009
Philadelphia,San Diego,11/15/2009,Jerome Boger,12,101,9,70,3,31,14,10,2009
New England,Indianapolis,11/15/2009,Scott Green,7,92,4,72,3,20,8,10,2009
Baltimore,Cleveland,11/16/2009,Carl Cheffers,13,95,7,43,6,52,17,10,2009
Miami,Carolina,11/19/2009,Walt Anderson,9,65,5,30,4,35,9,11,2009
Indianapolis,Baltimore,11/22/2009,John Parry,7,60,5,40,2,20,7,11,2009
Washington,Dallas,11/22/2009,Al Riveron,11,62,5,27,6,35,13,11,2009
Cleveland,Detroit,11/22/2009,Terry McAulay,16,110,8,69,8,41,17,11,2009
San Francisco,Green Bay,11/22/2009,Scott Green,10,94,4,30,6,64,11,11,2009
Buffalo,Jacksonville,11/22/2009,Mike Carey,12,93,6,43,6,50,13,11,2009
Pittsburgh,Kansas City,11/22/2009,Carl Cheffers,12,113,8,85,4,28,13,11,2009
Seattle,Minnesota,11/22/2009,Ed Hochuli,15,95,10,64,5,31,18,11,2009
Atlanta,N.Y. Giants,11/22/2009,Gene Steratore,11,80,3,16,8,64,16,11,2009
New Orleans,Tampa Bay,11/22/2009,Walt Coleman,7,73,4,55,3,18,7,11,2009
Arizona,St. Louis,11/22/2009,Bill Leavy,13,90,6,40,7,50,15,11,2009
San Diego,Denver,11/22/2009,Ron Winter,10,80,1,15,9,65,14,11,2009
N.Y. Jets,New England,11/22/2009,Jeff Triplette,11,79,5,28,6,51,14,11,2009
Cincinnati,Oakland,11/22/2009,Don Carey,11,72,8,59,3,13,12,11,2009
Philadelphia,Chicago,11/22/2009,Tony Corrente,15,110,8,46,7,64,15,11,2009
Tennessee,Houston,11/23/2009,Jerome Boger,12,97,5,25,7,72,14,11,2009
Green Bay,Detroit,11/26/2009,Bill Leavy,10,85,7,57,3,28,10,12,2009
Oakland,Dallas,11/26/2009,Carl Cheffers,13,118,7,70,6,48,14,12,2009
N.Y. Giants,Denver,11/26/2009,Tony Corrente,12,106,4,45,8,61,16,12,2009
Tampa Bay,Atlanta,11/29/2009,Walt Anderson,11,81,8,52,3,29,16,12,2009
Miami,Buffalo,11/29/2009,Jeff Triplette,9,70,6,50,3,20,11,12,2009
Cleveland,Cincinnati,11/29/2009,Mike Carey,14,105,4,30,10,75,16,12,2009
Indianapolis,Houston,11/29/2009,Al Riveron,13,154,3,25,10,129,13,12,2009
Chicago,Minnesota,11/29/2009,Walt Coleman,16,114,6,44,10,70,20,12,2009
Carolina,N.Y. Jets,11/29/2009,Jerome Boger,8,54,5,30,3,24,10,12,2009
Washington,Philadelphia,11/29/2009,Gene Steratore,14,99,7,39,7,60,18,12,2009
Seattle,St. Louis,11/29/2009,Scott Green,11,87,7,52,4,35,12,12,2009
Arizona,Tennessee,11/29/2009,Terry McAulay,10,63,4,25,6,38,10,12,2009
Kansas City,San Diego,11/29/2009,Don Carey,13,80,5,25,8,55,15,12,2009
Jacksonville,San Francisco,11/29/2009,John Parry,7,65,6,60,1,5,8,12,2009
Pittsburgh,Baltimore,11/29/2009,Ed Hochuli,14,139,5,59,9,80,16,12,2009
New England,New Orleans,11/30/2009,Pete Morelli,4,36,0,0,4,36,7,12,2009
N.Y. Jets,Buffalo,12/03/2009,Scott Green,4,23,3,18,1,5,4,13,2009
Philadelphia,Atlanta,12/06/2009,Ed Hochuli,14,92,8,62,6,30,20,13,2009
Tampa Bay,Carolina,12/06/2009,Don Carey,10,87,5,50,5,37,13,13,2009
St. Louis,Chicago,12/06/2009,Pete Morelli,10,120,6,85,4,35,10,13,2009
Detroit,Cincinnati,12/06/2009,Tony Corrente,16,120,7,45,9,75,20,13,2009
Tennessee,Indianapolis,12/06/2009,Ron Winter,9,90,4,50,5,40,9,13,2009
Houston,Jacksonville,12/06/2009,Terry McAulay,10,82,6,37,4,45,10,13,2009
Denver,Kansas City,12/06/2009,Jeff Triplette,6,45,3,20,3,25,10,13,2009
Oakland,Pittsburgh,12/06/2009,Jerome Boger,13,111,9,70,4,41,16,13,2009
New Orleans,Washington,12/06/2009,Carl Cheffers,9,117,7,102,2,15,10,13,2009
San Diego,Cleveland,12/06/2009,Walt Coleman,5,35,1,5,4,30,10,13,2009
Minnesota,Arizona,12/06/2009,John Parry,12,100,6,50,6,50,16,13,2009
Dallas,N.Y. Giants,12/06/2009,Bill Leavy,7,40,5,30,2,10,11,13,2009
San Francisco,Seattle,12/06/2009,Al Riveron,12,105,8,57,4,48,13,13,2009
New England,Miami,12/06/2009,Gene Steratore,8,92,6,82,2,10,10,13,2009
Baltimore,Green Bay,12/07/2009,Walt Anderson,23,310,12,135,11,175,24,13,2009
Pittsburgh,Cleveland,12/10/2009,Ron Winter,10,95,4,40,6,55,10,14,2009
New Orleans,Atlanta,12/13/2009,Tony Corrente,10,114,6,59,4,55,12,14,2009
Detroit,Baltimore,12/13/2009,Don Carey,9,90,4,40,5,50,10,14,2009
Green Bay,Chicago,12/13/2009,Mike Carey,17,139,4,30,13,109,18,14,2009
Seattle,Houston,12/13/2009,Pete Morelli,11,98,7,63,4,35,11,14,2009
Denver,Indianapolis,12/13/2009,Bill Leavy,11,85,7,65,4,20,11,14,2009
Miami,Jacksonville,12/13/2009,Walt Coleman,6,37,4,27,2,10,8,14,2009
Buffalo,Kansas City,12/13/2009,Al Riveron,8,83,3,40,5,43,11,14,2009
Cincinnati,Minnesota,12/13/2009,Scott Green,20,154,11,85,9,69,23,14,2009
Carolina,New England,12/13/2009,Terry McAulay,13,117,9,92,4,25,17,14,2009
N.Y. Jets,Tampa Bay,12/13/2009,Carl Cheffers,12,97,6,63,6,34,15,14,2009
St. Louis,Tennessee,12/13/2009,Jeff Triplette,14,122,10,82,4,40,19,14,2009
Washington,Oakland,12/13/2009,Walt Anderson,21,163,7,45,14,118,23,14,2009
San Diego,Dallas,12/13/2009,Gene Steratore,11,92,5,24,6,68,11,14,2009
Philadelphia,N.Y. Giants,12/13/2009,John Parry,13,99,6,45,7,54,16,14,2009
Arizona,San Francisco,12/14/2009,Jerome Boger,18,133,11,78,7,55,18,14,2009
Indianapolis,Jacksonville,12/17/2009,Walt Anderson,9,62,5,40,4,22,11,15,2009
Dallas,New Orleans,12/19/2009,Terry McAulay,10,79,6,49,4,30,11,15,2009
Chicago,Baltimore,12/20/2009,Bill Leavy,5,35,1,9,4,26,10,15,2009
New England,Buffalo,12/20/2009,Tony Corrente,17,176,6,52,11,124,18,15,2009
Arizona,Detroit,12/20/2009,Jeff Triplette,15,110,8,65,7,45,19,15,2009
Cleveland,Kansas City,12/20/2009,Gene Steratore,6,54,3,20,3,34,9,15,2009
Atlanta,N.Y. Jets,12/20/2009,Ron Winter,10,90,4,25,6,65,12,15,2009
San Francisco,Philadelphia,12/20/2009,Don Carey,12,124,8,55,4,69,15,15,2009
Green Bay,Pittsburgh,12/20/2009,John Parry,17,137,7,53,10,84,20,15,2009
Houston,St. Louis,12/20/2009,Ed Hochuli,7,45,4,30,3,15,10,15,2009
Miami,Tennessee,12/20/2009,Scott Green,12,106,8,60,4,46,14,15,2009
Oakland,Denver,12/20/2009,Al Riveron,16,134,9,62,7,72,16,15,2009
Cincinnati,San Diego,12/20/2009,Carl Cheffers,13,85,9,55,4,30,14,15,2009
Tampa Bay,Seattle,12/20/2009,Mike Carey,12,85,6,35,6,50,13,15,2009
Minnesota,Carolina,12/20/2009,Pete Morelli,11,94,5,45,6,49,12,15,2009
N.Y. Giants,Washington,12/21/2009,Walt Coleman,9,67,3,15,6,52,10,15,2009
San Diego,Tennessee,12/25/2009,Tony Corrente,15,119,6,45,9,74,15,16,2009
Buffalo,Atlanta,12/27/2009,Bill Leavy,16,130,10,60,6,70,17,16,2009
Kansas City,Cincinnati,12/27/2009,Ed Hochuli,12,76,6,40,6,36,13,16,2009
Oakland,Cleveland,12/27/2009,Jeff Triplette,19,190,13,126,6,64,24,16,2009
Seattle,Green Bay,12/27/2009,Walt Coleman,13,136,8,86,5,50,15,16,2009
Houston,Miami,12/27/2009,Ron Winter,7,45,3,15,4,30,10,16,2009
Carolina,N.Y. Giants,12/27/2009,Scott Green,8,49,4,20,4,29,11,16,2009
Jacksonville,New England,12/27/2009,Don Carey,3,15,1,5,2,10,3,16,2009
Tampa Bay,New Orleans,12/27/2009,Jerome Boger,9,56,7,42,2,14,11,16,2009
Denver,Philadelphia,12/27/2009,Mike Carey,18,154,9,95,9,59,20,16,2009
Baltimore,Pittsburgh,12/27/2009,Pete Morelli,15,133,11,113,4,20,17,16,2009
St. Louis,Arizona,12/27/2009,Al Riveron,7,35,4,20,3,15,9,16,2009
Detroit,San Francisco,12/27/2009,Walt Anderson,5,39,1,10,4,29,6,16,2009
N.Y. Jets,Indianapolis,12/27/2009,Terry McAulay,8,67,5,52,3,15,8,16,2009
Dallas,Washington,12/27/2009,John Parry,8,54,4,21,4,33,8,16,2009
Minnesota,Chicago,12/28/2009,Gene Steratore,7,78,4,47,3,31,10,16,2009
Indianapolis,Buffalo,01/03/2010,Don Carey,7,55,3,15,4,40,7,17,2009
New Orleans,Carolina,01/03/2010,Al Riveron,7,64,4,35,3,29,8,17,2009
Jacksonville,Cleveland,01/03/2010,Pete Morelli,6,35,3,20,3,15,6,17,2009
Philadelphia,Dallas,01/03/2010,Ron Winter,17,138,6,58,11,80,18,17,2009
Chicago,Detroit,01/03/2010,Jerome Boger,11,70,5,35,6,35,12,17,2009
New England,Houston,01/03/2010,John Parry,9,90,4,55,5,35,9,17,2009
Pittsburgh,Miami,01/03/2010,Bill Leavy,8,85,5,40,3,45,12,17,2009
N.Y. Giants,Minnesota,01/03/2010,Terry McAulay,21,140,13,95,8,45,21,17,2009
Cincinnati,N.Y. Jets,01/03/2010,Walt Anderson,11,64,7,44,4,20,13,17,2009
San Francisco,St. Louis,01/03/2010,Mike Carey,13,90,6,40,7,50,17,17,2009
Atlanta,Tampa Bay,01/03/2010,Gene Steratore,8,66,3,15,5,51,10,17,2009
Green Bay,Arizona,01/03/2010,Carl Cheffers,11,95,4,19,7,76,11,17,2009
Kansas City,Denver,01/03/2010,Scott Green,10,130,5,76,5,54,12,17,2009
Baltimore,Oakland,01/03/2010,Tony Corrente,10,67,5,37,5,30,10,17,2009
Washington,San Diego,01/03/2010,Jeff Triplette,5,31,3,14,2,17,5,17,2009
Tennessee,Seattle,01/03/2010,Ed Hochuli,14,116,9,76,5,40,16,17,2009
Minnesota,New Orleans,09/09/2010,Terry McAulay,9,80,6,60,3,20,15,1,2010
Cleveland,Tampa Bay,09/12/2010,Jeff Triplette,11,102,5,47,6,55,16,1,2010
Miami,Buffalo,09/12/2010,Clete Blakeman,8,50,3,15,5,35,8,1,2010
Cincinnati,New England,09/12/2010,Carl Cheffers,8,35,2,5,6,30,8,1,2010
Indianapolis,Houston,09/12/2010,Ed Hochuli,12,123,5,73,7,50,15,1,2010
Denver,Jacksonville,09/12/2010,Walt Coleman,12,117,7,70,5,47,13,1,2010
Oakland,Tennessee,09/12/2010,Bill Leavy,18,158,10,77,8,81,20,1,2010
Carolina,N.Y. Giants,09/12/2010,Jerome Boger,16,158,7,63,9,95,18,1,2010
Detroit,Chicago,09/12/2010,Gene Steratore,16,140,7,40,9,100,16,1,2010
Arizona,St. Louis,09/12/2010,Al Riveron,15,112,10,72,5,40,19,1,2010
Atlanta,Pittsburgh,09/12/2010,Scott Green,7,49,3,24,4,25,8,1,2010
Green Bay,Philadelphia,09/12/2010,John Parry,12,95,2,15,10,80,12,1,2010
San Francisco,Seattle,09/12/2010,Mike Carey,13,95,8,60,5,35,16,1,2010
Dallas,Washington,09/12/2010,Tony Corrente,17,133,12,91,5,42,21,1,2010
Baltimore,N.Y. Jets,09/13/2010,Walt Anderson,19,163,5,38,14,125,22,1,2010
San Diego,Kansas City,09/13/2010,Pete Morelli,8,65,5,30,3,35,8,1,2010
Houston,Washington,09/19/2010,Jeff Triplette,12,103,5,45,7,58,13,2,2010
Buffalo,Green Bay,09/19/2010,Ron Winter,10,84,4,35,6,49,14,2,2010
Miami,Minnesota,09/19/2010,Mike Carey,9,59,2,15,7,44,16,2,2010
Kansas City,Cleveland,09/19/2010,Carl Cheffers,13,108,4,30,9,78,14,2,2010
Pittsburgh,Tennessee,09/19/2010,John Parry,16,107,5,35,11,72,21,2,2010
Chicago,Dallas,09/19/2010,Scott Green,8,60,2,10,6,50,10,2,2010
Philadelphia,Detroit,09/19/2010,Clete Blakeman,18,126,9,75,9,51,21,2,2010
Arizona,Atlanta,09/19/2010,Jerome Boger,16,184,10,109,6,75,22,2,2010
Tampa Bay,Carolina,09/19/2010,Walt Coleman,8,78,4,30,4,48,11,2,2010
Seattle,Denver,09/19/2010,Walt Anderson,10,99,7,64,3,35,11,2,2010
St. Louis,Oakland,09/19/2010,Tony Corrente,20,182,8,92,12,90,22,2,2010
New England,N.Y. Jets,09/19/2010,Ed Hochuli,12,137,6,79,6,58,12,2,2010
Baltimore,Cincinnati,09/19/2010,Gene Steratore,14,101,5,45,9,56,18,2,2010
Jacksonville,San Diego,09/19/2010,Terry McAulay,9,58,5,33,4,25,9,2,2010
N.Y. Giants,Indianapolis,09/19/2010,Bill Leavy,9,80,3,25,6,55,11,2,2010
New Orleans,San Francisco,09/20/2010,Al Riveron,10,94,5,54,5,40,13,2,2010
Tennessee,N.Y. Giants,09/26/2010,Tony Corrente,19,166,8,80,11,86,22,3,2010
Cincinnati,Carolina,09/26/2010,Pete Morelli,14,114,8,69,6,45,14,3,2010
Pittsburgh,Tampa Bay,09/26/2010,Bill Leavy,6,65,2,20,4,45,8,3,2010
Buffalo,New England,09/26/2010,John Parry,10,80,6,45,4,35,10,3,2010
Cleveland,Baltimore,09/26/2010,Scott Green,16,120,8,60,8,60,17,3,2010
Detroit,Minnesota,09/26/2010,Ed Hochuli,20,167,8,67,12,100,25,3,2010
Atlanta,New Orleans,09/26/2010,Walt Anderson,10,78,6,40,4,38,11,3,2010
Washington,St. Louis,09/26/2010,Walt Coleman,18,164,9,65,9,99,23,3,2010
Dallas,Houston,09/26/2010,Carl Cheffers,13,81,8,49,5,32,22,3,2010
San Francisco,Kansas City,09/26/2010,Clete Blakeman,13,95,6,55,7,40,13,3,2010
Philadelphia,Jacksonville,09/26/2010,Jeff Triplette,11,151,7,84,4,67,14,3,2010
Indianapolis,Denver,09/26/2010,Al Riveron,10,87,4,27,6,60,11,3,2010
Oakland,Arizona,09/26/2010,Mike Carey,18,227,11,123,7,104,20,3,2010
San Diego,Seattle,09/26/2010,Ron Winter,16,115,11,83,5,32,16,3,2010
N.Y. Jets,Miami,09/26/2010,Jerome Boger,15,133,9,81,6,52,17,3,2010
Green Bay,Chicago,09/27/2010,Terry McAulay,23,190,18,152,5,38,25,3,2010
N.Y. Jets,Buffalo,10/03/2010,Bill Leavy,7,62,4,30,3,32,9,4,2010
Cincinnati,Cleveland,10/03/2010,Jerome Boger,15,123,8,79,7,44,15,4,2010
Baltimore,Pittsburgh,10/03/2010,Ed Hochuli,18,140,7,52,11,88,21,4,2010
Denver,Tennessee,10/03/2010,Clete Blakeman,16,185,6,74,10,111,19,4,2010
Detroit,Green Bay,10/03/2010,Mike Carey,16,133,13,102,3,31,20,4,2010
San Francisco,Atlanta,10/03/2010,Tony Corrente,10,101,6,41,4,60,12,4,2010
Carolina,New Orleans,10/03/2010,John Parry,8,102,4,66,4,36,8,4,2010
Seattle,St. Louis,10/03/2010,Pete Morelli,11,90,6,49,5,41,13,4,2010
Indianapolis,Jacksonville,10/03/2010,Ron Winter,10,80,3,35,7,45,10,4,2010
Houston,Oakland,10/03/2010,Scott Green,7,49,5,26,2,23,7,4,2010
Washington,Philadelphia,10/03/2010,Al Riveron,13,110,5,30,8,80,13,4,2010
Arizona,San Diego,10/03/2010,Gene Steratore,10,78,5,34,5,44,11,4,2010
Chicago,N.Y. Giants,10/03/2010,Carl Cheffers,14,84,8,40,6,44,15,4,2010
New England,Miami,10/04/2010,Walt Coleman,8,66,2,26,6,40,8,4,2010
Jacksonville,Buffalo,10/10/2010,Carl Cheffers,10,73,5,38,5,35,12,5,2010
Denver,Baltimore,10/10/2010,Jerome Boger,15,156,10,90,5,66,18,5,2010
Kansas City,Indianapolis,10/10/2010,Terry McAulay,9,83,4,38,5,45,10,5,2010
Green Bay,Washington,10/10/2010,Gene Steratore,13,91,9,63,4,28,13,5,2010
St. Louis,Detroit,10/10/2010,Bill Leavy,18,118,7,40,11,78,21,5,2010
Chicago,Carolina,10/10/2010,Mike Carey,12,98,5,45,7,53,17,5,2010
Tampa Bay,Cincinnati,10/10/2010,Scott Green,12,85,3,25,9,60,12,5,2010
Atlanta,Cleveland,10/10/2010,John Parry,13,118,6,60,7,58,14,5,2010
N.Y. Giants,Houston,10/10/2010,Walt Coleman,17,151,9,84,8,67,21,5,2010
New Orleans,Arizona,10/10/2010,Tony Corrente,9,65,6,45,3,20,13,5,2010
Tennessee,Dallas,10/10/2010,Jeff Triplette,16,173,4,40,12,133,19,5,2010
San Diego,Oakland,10/10/2010,Clete Blakeman,19,138,7,53,12,85,21,5,2010
Philadelphia,San Francisco,10/10/2010,Walt Anderson,15,95,5,30,10,65,17,5,2010
Minnesota,N.Y. Jets,10/11/2010,Pete Morelli,14,106,8,51,6,55,16,5,2010
Miami,Green Bay,10/17/2010,Ed Hochuli,11,75,4,30,7,45,12,6,2010
San Diego,St. Louis,10/17/2010,Scott Green,12,66,6,31,6,35,13,6,2010
Baltimore,New England,10/17/2010,Bill Leavy,17,145,8,67,9,78,21,6,2010
Cleveland,Pittsburgh,10/17/2010,Walt Anderson,8,71,4,46,4,25,11,6,2010
Kansas City,Houston,10/17/2010,Ron Winter,10,88,5,35,5,53,15,6,2010
Detroit,N.Y. Giants,10/17/2010,Jeff Triplette,13,106,11,91,2,15,14,6,2010
Atlanta,Philadelphia,10/17/2010,Walt Coleman,11,108,2,30,9,78,11,6,2010
Seattle,Chicago,10/17/2010,Al Riveron,7,101,5,83,2,18,8,6,2010
New Orleans,Tampa Bay,10/17/2010,Clete Blakeman,14,110,9,80,5,30,14,6,2010
N.Y. Jets,Denver,10/17/2010,Tony Corrente,11,155,6,74,5,81,15,6,2010
Oakland,San Francisco,10/17/2010,Carl Cheffers,19,203,8,60,11,143,21,6,2010
Dallas,Minnesota,10/17/2010,Gene Steratore,16,136,11,91,5,45,17,6,2010
Indianapolis,Washington,10/17/2010,John Parry,10,68,3,15,7,53,11,6,2010
Tennessee,Jacksonville,10/18/2010,Mike Carey,15,112,8,57,7,55,16,6,2010
Cincinnati,Atlanta,10/24/2010,Al Riveron,10,77,7,36,3,41,11,7,2010
Pittsburgh,Miami,10/24/2010,Gene Steratore,8,58,5,34,3,24,10,7,2010
Buffalo,Baltimore,10/24/2010,Pete Morelli,10,96,6,78,4,18,11,7,2010
Jacksonville,Kansas City,10/24/2010,Jerome Boger,13,135,6,43,7,92,13,7,2010
Cleveland,New Orleans,10/24/2010,Walt Coleman,10,123,4,30,6,93,10,7,2010
Washington,Chicago,10/24/2010,Walt Anderson,13,99,7,48,6,51,14,7,2010
San Francisco,Carolina,10/24/2010,Ron Winter,15,116,11,81,4,35,17,7,2010
St. Louis,Tampa Bay,10/24/2010,Mike Carey,18,137,6,45,12,92,21,7,2010
Philadelphia,Tennessee,10/24/2010,Ed Hochuli,16,137,10,100,6,37,19,7,2010
Arizona,Seattle,10/24/2010,Jeff Triplette,15,127,5,32,10,95,17,7,2010
New England,San Diego,10/24/2010,Tony Corrente,13,120,7,51,6,69,14,7,2010
Oakland,Denver,10/24/2010,Terry McAulay,15,158,10,94,5,64,18,7,2010
Minnesota,Green Bay,10/24/2010,Scott Green,8,60,6,40,2,20,8,7,2010
N.Y. Giants,Dallas,10/25/2010,John Parry,11,88,6,46,5,42,11,7,2010
Denver,San Francisco,10/31/2010,Scott Green,14,127,8,60,6,67,16,8,2010
Jacksonville,Dallas,10/31/2010,Clete Blakeman,9,56,6,36,3,20,9,8,2010
Miami,Cincinnati,10/31/2010,Terry McAulay,8,78,4,42,4,36,9,8,2010
Buffalo,Kansas City,10/31/2010,Al Riveron,10,85,5,35,5,50,11,8,2010
Washington,Detroit,10/31/2010,Jerome Boger,17,142,10,77,7,65,18,8,2010
Carolina,St. Louis,10/31/2010,Carl Cheffers,13,95,6,30,7,65,17,8,2010
Green Bay,N.Y. Jets,10/31/2010,Jeff Triplette,10,70,3,15,7,55,12,8,2010
Tennessee,San Diego,10/31/2010,Bill Leavy,18,142,10,80,8,62,19,8,2010
Minnesota,New England,10/31/2010,Walt Anderson,11,82,5,35,6,47,11,8,2010
Tampa Bay,Arizona,10/31/2010,Ron Winter,12,92,9,80,3,12,16,8,2010
Seattle,Oakland,10/31/2010,Ed Hochuli,18,160,7,55,11,105,19,8,2010
Pittsburgh,New Orleans,10/31/2010,Pete Morelli,7,73,4,38,3,35,9,8,2010
Houston,Indianapolis,11/01/2010,Tony Corrente,14,99,5,30,9,69,16,8,2010
N.Y. Jets,Detroit,11/07/2010,Al Riveron,22,201,11,99,11,102,26,9,2010
Miami,Baltimore,11/07/2010,John Parry,9,63,4,23,5,40,10,9,2010
New England,Cleveland,11/07/2010,Clete Blakeman,7,48,3,20,4,28,7,9,2010
San Diego,Houston,11/07/2010,Mike Carey,10,93,6,62,4,31,12,9,2010
Chicago,Buffalo,11/07/2010,Gene Steratore,11,78,7,45,4,33,13,9,2010
Arizona,Minnesota,11/07/2010,Bill Leavy,18,104,7,39,11,65,18,9,2010
Tampa Bay,Atlanta,11/07/2010,Terry McAulay,9,83,5,30,4,53,12,9,2010
New Orleans,Carolina,11/07/2010,Ed Hochuli,17,129,7,64,10,65,20,9,2010
N.Y. Giants,Seattle,11/07/2010,Pete Morelli,14,110,5,40,9,70,16,9,2010
Indianapolis,Philadelphia,11/07/2010,Carl Cheffers,21,184,7,59,14,125,24,9,2010
Kansas City,Oakland,11/07/2010,Jeff Triplette,27,240,12,100,15,140,33,9,2010
Dallas,Green Bay,11/07/2010,Walt Coleman,7,60,5,40,2,20,9,9,2010
Pittsburgh,Cincinnati,11/08/2010,Ron Winter,10,103,7,73,3,30,12,9,2010
Baltimore,Atlanta,11/11/2010,Ron Winter,7,56,6,51,1,5,9,10,2010
Tennessee,Miami,11/14/2010,Pete Morelli,9,118,5,55,4,63,10,10,2010
N.Y. Jets,Cleveland,11/14/2010,Terry McAulay,13,122,9,70,4,52,13,10,2010
Cincinnati,Indianapolis,11/14/2010,Walt Anderson,9,83,4,38,5,45,9,10,2010
Houston,Jacksonville,11/14/2010,Gene Steratore,16,111,8,49,8,62,19,10,2010
Minnesota,Chicago,11/14/2010,Tony Corrente,13,135,2,19,11,116,15,10,2010
Carolina,Tampa Bay,11/14/2010,Jerome Boger,17,151,7,71,10,80,19,10,2010
Detroit,Buffalo,11/14/2010,Walt Coleman,15,90,11,60,4,30,15,10,2010
Kansas City,Denver,11/14/2010,Mike Carey,9,68,6,40,3,28,12,10,2010
Dallas,N.Y. Giants,11/14/2010,Bill Leavy,13,129,5,60,8,69,18,10,2010
Seattle,Arizona,11/14/2010,Scott Green,16,101,6,51,10,50,16,10,2010
St. Louis,San Francisco,11/14/2010,Ed Hochuli,26,240,12,135,14,105,27,10,2010
New England,Pittsburgh,11/14/2010,Carl Cheffers,16,158,10,113,6,45,18,10,2010
Philadelphia,Washington,11/15/2010,Clete Blakeman,12,76,6,35,6,41,12,10,2010
Chicago,Miami,11/18/2010,Bill Leavy,10,90,5,45,5,45,11,11,2010
Baltimore,Carolina,11/21/2010,Al Riveron,10,74,3,20,7,54,11,11,2010
Houston,N.Y. Jets,11/21/2010,Jerome Boger,7,64,3,25,4,39,9,11,2010
Buffalo,Cincinnati,11/21/2010,Ed Hochuli,17,115,10,58,7,57,17,11,2010
Oakland,Pittsburgh,11/21/2010,Tony Corrente,21,218,7,55,14,163,28,11,2010
Cleveland,Jacksonville,11/21/2010,Pete Morelli,7,55,5,45,2,10,7,11,2010
Detroit,Dallas,11/21/2010,Carl Cheffers,16,115,10,76,6,39,17,11,2010
Green Bay,Minnesota,11/21/2010,Clete Blakeman,7,55,1,5,6,50,7,11,2010
Seattle,New Orleans,11/21/2010,Mike Carey,11,103,8,79,3,24,12,11,2010
Washington,Tennessee,11/21/2010,Terry McAulay,14,101,3,20,11,81,15,11,2010
Arizona,Kansas City,11/21/2010,Walt Coleman,16,119,11,96,5,23,16,11,2010
Atlanta,St. Louis,11/21/2010,Walt Anderson,10,84,3,30,7,54,13,11,2010
Tampa Bay,San Francisco,11/21/2010,John Parry,6,53,3,35,3,18,9,11,2010
Indianapolis,New England,11/21/2010,Gene Steratore,7,63,6,48,1,15,8,11,2010
N.Y. Giants,Philadelphia,11/21/2010,Ron Winter,16,173,6,54,10,119,16,11,2010
Denver,San Diego,11/22/2010,Jeff Triplette,13,96,8,56,5,40,17,11,2010
New England,Detroit,11/25/2010,Ron Winter,13,116,5,50,8,66,15,12,2010
New Orleans,Dallas,11/25/2010,Jerome Boger,8,49,4,30,4,19,11,12,2010
Cincinnati,N.Y. Jets,11/25/2010,Mike Carey,10,89,2,25,8,64,10,12,2010
Jacksonville,N.Y. Giants,11/28/2010,Terry McAulay,7,45,3,20,4,25,10,12,2010
Pittsburgh,Buffalo,11/28/2010,John Parry,14,127,10,107,4,20,17,12,2010
Tennessee,Houston,11/28/2010,Clete Blakeman,16,147,10,79,6,68,21,12,2010
Minnesota,Washington,11/28/2010,Ed Hochuli,9,50,3,15,6,35,10,12,2010
Philadelphia,Chicago,11/28/2010,Scott Green,9,75,3,19,6,56,9,12,2010
Green Bay,Atlanta,11/28/2010,Pete Morelli,12,116,8,66,4,50,13,12,2010
Tampa Bay,Baltimore,11/28/2010,Carl Cheffers,13,108,9,78,4,30,14,12,2010
Carolina,Cleveland,11/28/2010,Jeff Triplette,13,114,8,68,5,46,15,12,2010
Kansas City,Seattle,11/28/2010,Tony Corrente,8,76,5,50,3,26,9,12,2010
Miami,Oakland,11/28/2010,Walt Anderson,9,55,5,35,4,20,11,12,2010
St. Louis,Denver,11/28/2010,Bill Leavy,10,90,4,30,6,60,13,12,2010
San Diego,Indianapolis,11/28/2010,Al Riveron,5,55,4,40,1,15,6,12,2010
San Francisco,Arizona,11/29/2010,Gene Steratore,12,101,6,40,6,61,12,12,2010
Houston,Philadelphia,12/02/2010,Walt Anderson,15,110,4,25,11,85,19,13,2010
Buffalo,Minnesota,12/05/2010,Jerome Boger,10,74,6,54,4,20,12,13,2010
Cleveland,Miami,12/05/2010,Al Riveron,8,82,4,45,4,37,8,13,2010
Jacksonville,Tennessee,12/05/2010,Ron Winter,8,61,4,31,4,30,10,13,2010
Denver,Kansas City,12/05/2010,Carl Cheffers,12,95,4,35,8,60,14,13,2010
Washington,N.Y. Giants,12/05/2010,Walt Coleman,10,70,5,35,5,35,12,13,2010
Chicago,Detroit,12/05/2010,Ed Hochuli,10,67,4,25,6,42,12,13,2010
San Francisco,Green Bay,12/05/2010,Bill Leavy,11,72,6,32,5,40,15,13,2010
Atlanta,Tampa Bay,12/05/2010,Tony Corrente,15,157,6,55,9,102,16,13,2010
New Orleans,Cincinnati,12/05/2010,Jeff Triplette,18,143,11,100,7,43,19,13,2010
Oakland,San Diego,12/05/2010,John Parry,16,124,13,105,3,19,18,13,2010
Dallas,Indianapolis,12/05/2010,Pete Morelli,8,63,5,35,3,28,9,13,2010
St. Louis,Arizona,12/05/2010,Clete Blakeman,8,69,2,15,6,54,11,13,2010
Carolina,Seattle,12/05/2010,Gene Steratore,12,73,8,53,4,20,13,13,2010
Pittsburgh,Baltimore,12/05/2010,Terry McAulay,18,114,9,61,9,53,19,13,2010
N.Y. Jets,New England,12/06/2010,Scott Green,5,66,4,56,1,10,6,13,2010
Indianapolis,Tennessee,12/09/2010,John Parry,12,89,7,60,5,29,13,14,2010
New England,Chicago,12/12/2010,Mike Carey,8,73,4,43,4,30,8,14,2010
Cleveland,Buffalo,12/12/2010,Scott Green,8,54,2,10,6,44,9,14,2010
Cincinnati,Pittsburgh,12/12/2010,Walt Coleman,13,114,4,25,9,89,14,14,2010
Oakland,Jacksonville,12/12/2010,Al Riveron,10,77,4,25,6,52,11,14,2010
Tampa Bay,Washington,12/12/2010,Pete Morelli,6,39,2,14,4,25,6,14,2010
Green Bay,Detroit,12/12/2010,Gene Steratore,9,55,3,20,6,35,13,14,2010
Atlanta,Carolina,12/12/2010,Clete Blakeman,7,60,1,10,6,50,7,14,2010
St. Louis,New Orleans,12/12/2010,Tony Corrente,9,94,4,39,5,55,9,14,2010
Seattle,San Francisco,12/12/2010,Carl Cheffers,10,90,8,75,2,15,11,14,2010
Miami,N.Y. Jets,12/12/2010,Ron Winter,11,86,5,36,6,50,13,14,2010
Denver,Arizona,12/12/2010,Jerome Boger,15,128,8,66,7,62,19,14,2010
Kansas City,San Diego,12/12/2010,Walt Anderson,8,62,2,15,6,47,10,14,2010
Philadelphia,Dallas,12/12/2010,Terry McAulay,11,99,6,59,5,40,12,14,2010
Baltimore,Houston,12/13/2010,Bill Leavy,11,66,3,15,8,51,12,14,2010
N.Y. Giants,Minnesota,12/12/2010,Jeff Triplette,17,126,7,55,10,71,21,14,2010
San Francisco,San Diego,12/16/2010,Clete Blakeman,9,95,5,60,4,35,9,15,2010
Kansas City,St. Louis,12/19/2010,Ron Winter,14,100,5,40,9,60,18,15,2010
Buffalo,Miami,12/19/2010,Jeff Triplette,9,79,5,44,4,35,11,15,2010
Cleveland,Cincinnati,12/19/2010,Jerome Boger,9,80,3,25,6,55,15,15,2010
Jacksonville,Indianapolis,12/19/2010,Mike Carey,12,123,6,55,6,68,13,15,2010
Houston,Tennessee,12/19/2010,Gene Steratore,21,142,9,66,12,76,23,15,2010
Washington,Dallas,12/19/2010,Al Riveron,12,95,3,25,9,70,12,15,2010
Philadelphia,N.Y. Giants,12/19/2010,John Parry,9,65,5,30,4,35,10,15,2010
Arizona,Carolina,12/19/2010,Tony Corrente,10,97,4,39,6,58,12,15,2010
Detroit,Tampa Bay,12/19/2010,Terry McAulay,16,122,7,57,9,65,17,15,2010
New Orleans,Baltimore,12/19/2010,Walt Anderson,15,136,5,68,10,68,19,15,2010
Atlanta,Seattle,12/19/2010,Walt Coleman,14,111,4,35,10,76,16,15,2010
N.Y. Jets,Pittsburgh,12/19/2010,Pete Morelli,6,54,3,19,3,35,8,15,2010
Denver,Oakland,12/19/2010,Scott Green,19,177,10,93,9,84,21,15,2010
Green Bay,New England,12/19/2010,Ed Hochuli,9,67,2,15,7,52,10,15,2010
Chicago,Minnesota,12/20/2010,Carl Cheffers,11,127,5,72,6,55,19,15,2010
Carolina,Pittsburgh,12/23/2010,Bill Leavy,10,102,6,62,4,40,13,16,2010
Dallas,Arizona,12/25/2010,Jeff Triplette,13,92,7,49,6,43,15,16,2010
N.Y. Jets,Chicago,12/26/2010,Walt Coleman,9,65,3,34,6,31,10,16,2010
New England,Buffalo,12/26/2010,Al Riveron,12,80,6,40,6,40,12,16,2010
Baltimore,Cleveland,12/26/2010,John Parry,3,25,1,5,2,20,6,16,2010
Tennessee,Kansas City,12/26/2010,Scott Green,16,158,9,74,7,84,24,16,2010
Seattle,Tampa Bay,12/26/2010,Clete Blakeman,4,32,1,10,3,22,4,16,2010
San Francisco,St. Louis,12/26/2010,Pete Morelli,13,128,8,87,5,41,16,16,2010
Detroit,Miami,12/26/2010,Tony Corrente,14,116,6,53,8,63,16,16,2010
Washington,Jacksonville,12/26/2010,Jerome Boger,12,106,5,40,7,66,14,16,2010
Houston,Denver,12/26/2010,Ron Winter,7,51,3,24,4,27,8,16,2010
Indianapolis,Oakland,12/26/2010,Terry McAulay,14,158,4,42,10,116,15,16,2010
N.Y. Giants,Green Bay,12/26/2010,Walt Anderson,8,76,5,45,3,31,8,16,2010
San Diego,Cincinnati,12/26/2010,Gene Steratore,7,62,1,5,6,57,9,16,2010
New Orleans,Atlanta,12/27/2010,Ed Hochuli,9,102,8,92,1,10,15,16,2010
Minnesota,Philadelphia,12/28/2010,Mike Carey,17,136,5,74,12,62,18,16,2010
Miami,New England,01/02/2011,Terry McAulay,10,112,5,40,5,72,10,17,2010
Buffalo,N.Y. Jets,01/02/2011,Carl Cheffers,6,40,3,15,3,25,8,17,2010
Cincinnati,Baltimore,01/02/2011,Pete Morelli,11,94,4,49,7,45,15,17,2010
Pittsburgh,Cleveland,01/02/2011,Ron Winter,9,71,3,25,6,46,12,17,2010
Jacksonville,Houston,01/02/2011,Jeff Triplette,7,63,2,15,5,48,7,17,2010
Tennessee,Indianapolis,01/02/2011,Ed Hochuli,12,83,7,58,5,25,14,17,2010
Oakland,Kansas City,01/02/2011,Bill Leavy,15,116,10,77,5,39,15,17,2010
Dallas,Philadelphia,01/02/2011,Tony Corrente,10,85,6,45,4,40,11,17,2010
N.Y. Giants,Washington,01/02/2011,Scott Green,6,49,2,24,4,25,7,17,2010
Minnesota,Detroit,01/02/2011,Walt Anderson,8,58,3,25,5,33,12,17,2010
Chicago,Green Bay,01/02/2011,Al Riveron,10,76,6,46,4,30,10,17,2010
Carolina,Atlanta,01/02/2011,John Parry,14,117,10,97,4,20,14,17,2010
Tampa Bay,New Orleans,01/02/2011,Gene Steratore,12,99,7,54,5,45,14,17,2010
San Diego,Denver,01/02/2011,Walt Coleman,8,77,3,32,5,45,12,17,2010
Arizona,San Francisco,01/02/2011,Mike Carey,13,68,8,43,5,25,16,17,2010
St. Louis,Seattle,01/02/2011,Jerome Boger,13,116,6,46,7,70,13,17,2010
New Orleans,Green Bay,09/08/2011,Clete Blakeman,9,63,3,15,6,48,11,1,2011
Pittsburgh,Baltimore,09/11/2011,Tony Corrente,13,128,6,53,7,75,13,1,2011
Cincinnati,Cleveland,09/11/2011,Bill Leavy,14,94,3,22,11,72,18,1,2011
Indianapolis,Houston,09/11/2011,Walt Coleman,10,90,6,60,4,30,11,1,2011
Tennessee,Jacksonville,09/11/2011,Mike Carey,12,99,7,60,5,39,17,1,2011
Buffalo,Kansas City,09/11/2011,Scott Green,6,33,5,30,1,3,9,1,2011
Atlanta,Chicago,09/11/2011,Ed Hochuli,17,121,9,65,8,56,18,1,2011
Detroit,Tampa Bay,09/11/2011,Walt Anderson,14,107,8,68,6,39,16,1,2011
Philadelphia,St. Louis,09/11/2011,Gene Steratore,17,151,8,91,9,60,21,1,2011
N.Y. Giants,Washington,09/11/2011,Ron Winter,11,88,8,63,3,25,11,1,2011
Carolina,Arizona,09/11/2011,Carl Cheffers,16,135,10,74,6,61,18,1,2011
Seattle,San Francisco,09/11/2011,Jeff Triplette,20,174,11,72,9,102,27,1,2011
Minnesota,San Diego,09/11/2011,Terry McAulay,13,104,9,78,4,26,14,1,2011
Dallas,N.Y. Jets,09/11/2011,Al Riveron,7,40,7,40,0,0,7,1,2011
New England,Miami,09/12/2011,Pete Morelli,15,110,7,50,8,60,19,1,2011
Oakland,Denver,09/12/2011,Jerome Boger,25,222,15,131,10,91,29,1,2011
Kansas City,Detroit,09/18/2011,Tony Corrente,12,105,8,70,4,35,15,2,2011
Oakland,Buffalo,09/18/2011,Mike Carey,11,111,8,85,3,26,12,2,2011
Baltimore,Tennessee,09/18/2011,Clete Blakeman,13,114,7,44,6,70,13,2,2011
Jacksonville,N.Y. Jets,09/18/2011,Scott Green,11,110,4,50,7,60,12,2,2011
Cleveland,Indianapolis,09/18/2011,Gene Steratore,7,70,3,49,4,21,9,2,2011
Arizona,Washington,09/18/2011,Pete Morelli,13,112,10,97,3,15,16,2,2011
Tampa Bay,Minnesota,09/18/2011,Jeff Triplette,14,118,6,53,8,65,16,2,2011
Green Bay,Carolina,09/18/2011,Al Riveron,13,107,7,57,6,50,15,2,2011
Chicago,New Orleans,09/18/2011,Walt Coleman,13,88,6,47,7,41,14,2,2011
Seattle,Pittsburgh,09/18/2011,Bill Leavy,10,114,6,66,4,48,12,2,2011
Dallas,San Francisco,09/18/2011,Ron Winter,13,108,8,83,5,25,13,2,2011
San Diego,New England,09/18/2011,Walt Anderson,14,124,6,44,8,80,17,2,2011
Cincinnati,Denver,09/18/2011,Ed Hochuli,14,124,7,69,7,55,15,2,2011
Houston,Miami,09/18/2011,John Parry,7,96,4,76,3,20,10,2,2011
Philadelphia,Atlanta,09/18/2011,Carl Cheffers,11,77,4,20,7,57,17,2,2011
St. Louis,N.Y. Giants,09/19/2011,Terry McAulay,13,140,8,85,5,55,14,2,2011
Jacksonville,Carolina,09/25/2011,Bill Leavy,16,129,8,60,8,69,16,3,2011
Houston,New Orleans,09/25/2011,Tony Corrente,11,82,7,56,4,26,13,3,2011
New England,Buffalo,09/25/2011,Carl Cheffers,17,170,8,93,9,77,19,3,2011
Miami,Cleveland,09/25/2011,Walt Anderson,18,178,10,93,8,85,18,3,2011
Denver,Tennessee,09/25/2011,John Parry,12,95,1,15,11,80,12,3,2011
N.Y. Giants,Philadelphia,09/25/2011,Jeff Triplette,11,57,4,21,7,36,12,3,2011
Detroit,Minnesota,09/25/2011,Ron Winter,17,144,7,65,10,79,23,3,2011
San Francisco,Cincinnati,09/25/2011,Jerome Boger,18,110,12,70,6,40,20,3,2011
N.Y. Jets,Oakland,09/25/2011,Gene Steratore,14,116,7,61,7,55,16,3,2011
Kansas City,San Diego,09/25/2011,Walt Coleman,11,105,7,65,4,40,12,3,2011
Baltimore,St. Louis,09/25/2011,Scott Green,12,134,5,32,7,102,13,3,2011
Green Bay,Chicago,09/25/2011,Mike Carey,17,105,7,35,10,70,24,3,2011
Arizona,Seattle,09/25/2011,Al Riveron,10,59,2,20,8,39,13,3,2011
Atlanta,Tampa Bay,09/25/2011,Clete Blakeman,16,116,7,50,9,66,20,3,2011
Pittsburgh,Indianapolis,09/25/2011,Terry McAulay,7,59,4,38,3,21,8,3,2011
Washington,Dallas,09/26/2011,Ed Hochuli,10,90,4,35,6,55,10,3,2011
Buffalo,Cincinnati,10/02/2011,Gene Steratore,7,41,4,26,3,15,9,4,2011
Tennessee,Cleveland,10/02/2011,Pete Morelli,10,85,5,45,5,40,12,4,2011
Pittsburgh,Houston,10/02/2011,Clete Blakeman,14,109,5,45,9,64,15,4,2011
Detroit,Dallas,10/02/2011,John Parry,17,108,10,75,7,33,21,4,2011
San Francisco,Philadelphia,10/02/2011,Al Riveron,10,95,5,40,5,55,12,4,2011
Carolina,Chicago,10/02/2011,Terry McAulay,13,97,8,52,5,45,13,4,2011
Washington,St. Louis,10/02/2011,Walt Coleman,19,161,10,96,9,65,21,4,2011
New Orleans,Jacksonville,10/02/2011,Ed Hochuli,8,65,6,50,2,15,9,4,2011
Minnesota,Kansas City,10/02/2011,Bill Leavy,12,102,6,45,6,57,16,4,2011
N.Y. Giants,Arizona,10/02/2011,Jerome Boger,18,173,8,70,10,103,22,4,2011
Atlanta,Seattle,10/02/2011,Walt Anderson,10,75,5,50,5,25,12,4,2011
Denver,Green Bay,10/02/2011,Scott Green,6,51,3,24,3,27,7,4,2011
New England,Oakland,10/02/2011,Tony Corrente,14,130,5,45,9,85,16,4,2011
Miami,San Diego,10/02/2011,Jeff Triplette,10,121,2,41,8,80,10,4,2011
N.Y. Jets,Baltimore,10/02/2011,Mike Carey,16,115,9,69,7,46,16,4,2011
Indianapolis,Tampa Bay,10/03/2011,Ron Winter,20,156,6,50,14,106,22,4,2011
Tennessee,Pittsburgh,10/09/2011,Walt Anderson,14,121,10,85,4,36,15,5,2011
Oakland,Houston,10/09/2011,Pete Morelli,17,139,11,89,6,50,18,5,2011
Kansas City,Indianapolis,10/09/2011,Carl Cheffers,9,79,5,39,4,40,15,5,2011
Cincinnati,Jacksonville,10/09/2011,Al Riveron,6,48,4,33,2,15,10,5,2011
Seattle,N.Y. Giants,10/09/2011,Ed Hochuli,17,122,10,70,7,52,20,5,2011
Arizona,Minnesota,10/09/2011,Scott Green,11,99,6,64,5,35,12,5,2011
New Orleans,Carolina,10/09/2011,John Parry,16,147,9,82,7,65,16,5,2011
Philadelphia,Buffalo,10/09/2011,Walt Coleman,9,86,5,46,4,40,10,5,2011
Tampa Bay,San Francisco,10/09/2011,Terry McAulay,12,126,9,96,3,30,14,5,2011
N.Y. Jets,New England,10/09/2011,Jerome Boger,14,139,8,89,6,50,14,5,2011
San Diego,Denver,10/09/2011,Gene Steratore,4,53,0,0,4,53,7,5,2011
Green Bay,Atlanta,10/09/2011,Jeff Triplette,11,99,6,55,5,44,12,5,2011
Chicago,Detroit,10/10/2011,Clete Blakeman,26,198,14,104,12,94,26,5,2011
Buffalo,N.Y. Giants,10/16/2011,Clete Blakeman,14,154,8,91,6,63,17,6,2011
Indianapolis,Cincinnati,10/16/2011,John Parry,13,122,2,11,11,111,15,6,2011
Jacksonville,Pittsburgh,10/16/2011,Ron Winter,12,87,4,22,8,65,14,6,2011
Philadelphia,Washington,10/16/2011,Bill Leavy,17,135,8,60,9,75,18,6,2011
San Francisco,Detroit,10/16/2011,Mike Carey,21,174,15,120,6,54,23,6,2011
St. Louis,Green Bay,10/16/2011,Ed Hochuli,10,61,7,45,3,16,12,6,2011
Carolina,Atlanta,10/16/2011,Pete Morelli,11,142,7,85,4,57,16,6,2011
Cleveland,Oakland,10/16/2011,Carl Cheffers,10,69,5,34,5,35,11,6,2011
Houston,Baltimore,10/16/2011,Gene Steratore,10,40,5,15,5,25,12,6,2011
New Orleans,Tampa Bay,10/16/2011,Jerome Boger,14,117,7,53,7,64,17,6,2011
Dallas,New England,10/16/2011,Walt Coleman,15,112,10,77,5,35,20,6,2011
Minnesota,Chicago,10/16/2011,Walt Anderson,8,55,5,40,3,15,9,6,2011
Miami,N.Y. Jets,10/17/2011,Tony Corrente,8,59,2,10,6,49,10,6,2011
Denver,Miami,10/23/2011,Clete Blakeman,7,50,5,30,2,20,8,7,2011
San Diego,N.Y. Jets,10/23/2011,Ron Winter,21,155,13,95,8,60,22,7,2011
Houston,Tennessee,10/23/2011,Terry McAulay,14,144,6,68,8,76,15,7,2011
Atlanta,Detroit,10/23/2011,Bill Leavy,21,164,11,80,10,84,25,7,2011
Washington,Carolina,10/23/2011,Jerome Boger,16,131,3,26,13,105,18,7,2011
Chicago,Tampa Bay,10/23/2011,Tony Corrente,15,123,7,54,8,69,17,7,2011
Seattle,Cleveland,10/23/2011,Mike Carey,15,116,8,68,7,48,16,7,2011
Pittsburgh,Arizona,10/23/2011,John Parry,18,136,9,69,9,67,20,7,2011
Kansas City,Oakland,10/23/2011,Jeff Triplette,24,218,10,98,14,120,26,7,2011
Green Bay,Minnesota,10/23/2011,Pete Morelli,15,135,6,44,9,91,15,7,2011
St. Louis,Dallas,10/23/2011,Al Riveron,10,46,4,16,6,30,10,7,2011
Indianapolis,New Orleans,10/23/2011,Scott Green,8,59,7,49,1,10,9,7,2011
Baltimore,Jacksonville,10/24/2011,Carl Cheffers,16,175,10,85,6,90,20,7,2011
Miami,N.Y. Giants,10/30/2011,Ron Winter,11,76,4,30,7,46,12,8,2011
Jacksonville,Houston,10/30/2011,Scott Green,12,99,5,39,7,60,13,8,2011
Indianapolis,Tennessee,10/30/2011,Jerome Boger,13,106,10,66,3,40,15,8,2011
Minnesota,Carolina,10/30/2011,Ed Hochuli,10,103,4,43,6,60,10,8,2011
New Orleans,St. Louis,10/30/2011,Walt Anderson,14,96,5,32,9,64,15,8,2011
Arizona,Baltimore,10/30/2011,Jeff Triplette,23,191,12,92,11,99,25,8,2011
Detroit,Denver,10/30/2011,Walt Coleman,9,100,4,45,5,55,17,8,2011
Washington,Buffalo,10/30/2011,Terry McAulay,9,89,3,54,6,35,9,8,2011
New England,Pittsburgh,10/30/2011,Mike Carey,14,87,6,37,8,50,18,8,2011
Cleveland,San Francisco,10/30/2011,Bill Leavy,10,79,5,39,5,40,12,8,2011
Cincinnati,Seattle,10/30/2011,Tony Corrente,18,145,7,65,11,80,18,8,2011
Dallas,Philadelphia,10/30/2011,Gene Steratore,9,53,3,20,6,33,9,8,2011
San Diego,Kansas City,10/31/2011,Al Riveron,21,158,12,105,9,53,22,8,2011
N.Y. Jets,Buffalo,11/06/2011,Ed Hochuli,15,144,9,60,6,84,15,9,2011
Cleveland,Houston,11/06/2011,Al Riveron,6,50,4,35,2,15,9,9,2011
Miami,Kansas City,11/06/2011,Walt Anderson,15,119,7,49,8,70,16,9,2011
Seattle,Dallas,11/06/2011,Terry McAulay,17,170,10,88,7,82,17,9,2011
San Francisco,Washington,11/06/2011,Gene Steratore,12,90,9,55,3,35,15,9,2011
Tampa Bay,New Orleans,11/06/2011,Carl Cheffers,17,143,9,80,8,63,17,9,2011
Atlanta,Indianapolis,11/06/2011,Mike Carey,7,42,1,10,6,32,8,9,2011
Denver,Oakland,11/06/2011,John Parry,26,223,11,93,15,130,30,9,2011
Cincinnati,Tennessee,11/06/2011,Jeff Triplette,16,187,9,87,7,100,18,9,2011
N.Y. Giants,New England,11/06/2011,Pete Morelli,13,131,6,50,7,81,13,9,2011
Green Bay,San Diego,11/06/2011,Clete Blakeman,13,97,5,33,8,64,14,9,2011
St. Louis,Arizona,11/06/2011,Ron Winter,15,116,9,71,6,45,16,9,2011
Baltimore,Pittsburgh,11/06/2011,Walt Coleman,9,89,3,20,6,69,11,9,2011
Chicago,Philadelphia,11/07/2011,Scott Green,12,97,6,53,6,44,12,9,2011
Oakland,San Diego,11/10/2011,Ed Hochuli,13,76,7,45,6,31,14,10,2011
Buffalo,Dallas,11/13/2011,Jerome Boger,11,86,3,12,8,74,11,10,2011
Tennessee,Carolina,11/13/2011,Walt Coleman,21,191,9,92,12,99,26,10,2011
Houston,Tampa Bay,11/13/2011,John Parry,14,103,8,54,6,49,15,10,2011
Pittsburgh,Cincinnati,11/13/2011,Bill Leavy,8,66,4,31,4,35,13,10,2011
Jacksonville,Indianapolis,11/13/2011,Jeff Triplette,11,95,5,55,6,40,12,10,2011
Denver,Kansas City,11/13/2011,Ron Winter,12,105,8,65,4,40,13,10,2011
Arizona,Philadelphia,11/13/2011,Walt Anderson,18,163,7,66,11,97,19,10,2011
Detroit,Chicago,11/13/2011,Pete Morelli,8,90,4,53,4,37,11,10,2011
New Orleans,Atlanta,11/13/2011,Terry McAulay,18,164,8,79,10,85,20,10,2011
Washington,Miami,11/13/2011,Carl Cheffers,12,106,6,51,6,55,15,10,2011
St. Louis,Cleveland,11/13/2011,Clete Blakeman,13,115,7,55,6,60,16,10,2011
Baltimore,Seattle,11/13/2011,Scott Green,17,134,4,34,13,100,21,10,2011
N.Y. Giants,San Francisco,11/13/2011,Tony Corrente,11,80,6,45,5,35,13,10,2011
New England,N.Y. Jets,11/13/2011,Gene Steratore,14,136,9,80,5,56,17,10,2011
Minnesota,Green Bay,11/14/2011,Mike Carey,11,85,10,80,1,5,12,10,2011
N.Y. Jets,Denver,11/17/2011,Bill Leavy,8,66,2,15,6,51,8,11,2011
Oakland,Minnesota,11/20/2011,Jerome Boger,21,167,12,117,9,50,25,11,2011
Tennessee,Atlanta,11/20/2011,John Parry,15,141,10,86,5,55,17,11,2011
Buffalo,Miami,11/20/2011,Walt Coleman,7,77,3,27,4,50,9,11,2011
Jacksonville,Cleveland,11/20/2011,Terry McAulay,18,151,9,81,9,70,20,11,2011
Cincinnati,Baltimore,11/20/2011,Ron Winter,12,112,6,43,6,69,13,11,2011
Dallas,Washington,11/20/2011,Ed Hochuli,15,107,9,48,6,59,15,11,2011
Carolina,Detroit,11/20/2011,Gene Steratore,15,126,7,70,8,56,18,11,2011
Tampa Bay,Green Bay,11/20/2011,Al Riveron,14,92,9,55,5,37,19,11,2011
Arizona,San Francisco,11/20/2011,Pete Morelli,13,162,6,75,7,87,13,11,2011
Seattle,St. Louis,11/20/2011,Carl Cheffers,18,150,13,100,5,50,22,11,2011
San Diego,Chicago,11/20/2011,Jeff Triplette,9,81,3,20,6,61,11,11,2011
Philadelphia,N.Y. Giants,11/20/2011,Mike Carey,10,69,5,30,5,39,16,11,2011
Kansas City,New England,11/21/2011,Clete Blakeman,8,54,5,34,3,20,12,11,2011
Green Bay,Detroit,11/24/2011,Terry McAulay,18,136,7,54,11,82,21,12,2011
Miami,Dallas,11/24/2011,Pete Morelli,17,124,6,55,11,69,19,12,2011
San Francisco,Baltimore,11/24/2011,John Parry,10,117,7,97,3,20,10,12,2011
Buffalo,N.Y. Jets,11/27/2011,Carl Cheffers,13,125,9,85,4,40,16,12,2011
Cleveland,Cincinnati,11/27/2011,Walt Anderson,8,50,3,15,5,35,11,12,2011
Houston,Jacksonville,11/27/2011,Walt Coleman,11,110,7,80,4,30,15,12,2011
Minnesota,Atlanta,11/27/2011,Al Riveron,10,79,6,49,4,30,13,12,2011
Arizona,St. Louis,11/27/2011,Mike Carey,12,79,4,30,8,49,13,12,2011
Carolina,Indianapolis,11/27/2011,Tony Corrente,8,107,6,92,2,15,8,12,2011
Tampa Bay,Tennessee,11/27/2011,Bill Leavy,9,80,4,30,5,50,11,12,2011
Washington,Seattle,11/27/2011,Clete Blakeman,19,206,10,115,9,91,23,12,2011
Chicago,Oakland,11/27/2011,Ron Winter,13,105,7,61,6,44,15,12,2011
New England,Philadelphia,11/27/2011,Jerome Boger,13,80,3,20,10,60,18,12,2011
Denver,San Diego,11/27/2011,Jeff Triplette,13,93,9,63,4,30,15,12,2011
Pittsburgh,Kansas City,11/27/2011,Ed Hochuli,10,70,6,50,4,20,17,12,2011
N.Y. Giants,New Orleans,11/28/2011,Gene Steratore,15,136,4,32,11,104,16,12,2011
Philadelphia,Seattle,12/01/2011,Pete Morelli,10,58,5,28,5,30,13,13,2011
N.Y. Jets,Washington,12/04/2011,John Parry,12,90,6,40,6,50,15,13,2011
Kansas City,Chicago,12/04/2011,Jerome Boger,13,95,8,60,5,35,15,13,2011
Tennessee,Buffalo,12/04/2011,Al Riveron,5,35,3,20,2,15,9,13,2011
Oakland,Miami,12/04/2011,Mike Carey,18,170,10,91,8,79,18,13,2011
Baltimore,Cleveland,12/04/2011,Ed Hochuli,7,55,4,18,3,37,8,13,2011
Cincinnati,Pittsburgh,12/04/2011,Carl Cheffers,14,138,10,109,4,29,18,13,2011
Detroit,New Orleans,12/04/2011,Clete Blakeman,14,137,11,107,3,30,16,13,2011
Carolina,Tampa Bay,12/04/2011,Gene Steratore,11,93,2,20,9,73,13,13,2011
Atlanta,Houston,12/04/2011,Bill Leavy,12,78,7,43,5,35,17,13,2011
Denver,Minnesota,12/04/2011,Terry McAulay,14,127,8,73,6,54,15,13,2011
Green Bay,N.Y. Giants,12/04/2011,Jeff Triplette,10,85,4,30,6,55,10,13,2011
Dallas,Arizona,12/04/2011,Walt Coleman,13,90,7,49,6,41,15,13,2011
St. Louis,San Francisco,12/04/2011,Pete Morelli,13,107,5,35,8,72,17,13,2011
Indianapolis,New England,12/04/2011,Ron Winter,8,49,5,29,3,20,8,13,2011
San Diego,Jacksonville,12/05/2011,Walt Anderson,9,81,6,55,3,26,12,13,2011
Cleveland,Pittsburgh,12/08/2011,Ed Hochuli,18,151,6,54,12,97,20,14,2011
New England,Washington,12/11/2011,Jeff Triplette,12,120,5,57,7,63,15,14,2011
Oakland,Green Bay,12/11/2011,Pete Morelli,16,124,11,89,5,35,18,14,2011
Kansas City,N.Y. Jets,12/11/2011,Terry McAulay,15,150,11,128,4,22,16,14,2011
Houston,Cincinnati,12/11/2011,Ed Hochuli,8,77,5,50,3,27,9,14,2011
Indianapolis,Baltimore,12/11/2011,Clete Blakeman,8,55,3,15,5,40,9,14,2011
Minnesota,Detroit,12/11/2011,John Parry,14,108,4,32,10,76,14,14,2011
Atlanta,Carolina,12/11/2011,Walt Anderson,10,100,5,50,5,50,11,14,2011
Philadelphia,Miami,12/11/2011,Ron Winter,14,150,7,69,7,81,17,14,2011
Tampa Bay,Jacksonville,12/11/2011,Jerome Boger,20,177,12,97,8,80,22,14,2011
New Orleans,Tennessee,12/11/2011,Mike Carey,19,149,11,95,8,54,22,14,2011
San Francisco,Arizona,12/11/2011,Al Riveron,9,80,5,35,4,45,10,14,2011
Chicago,Denver,12/11/2011,Carl Cheffers,12,97,8,69,4,28,14,14,2011
Buffalo,San Diego,12/11/2011,Gene Steratore,6,55,1,5,5,50,7,14,2011
N.Y. Giants,Dallas,12/11/2011,Scott Green,16,106,6,55,10,51,18,14,2011
St. Louis,Seattle,12/12/2011,Bill Leavy,14,91,5,30,9,61,14,14,2011
Jacksonville,Atlanta,12/15/2011,Ron Winter,9,71,5,40,4,31,9,15,2011
Dallas,Tampa Bay,12/17/2011,Terry McAulay,8,61,2,15,6,46,9,15,2011
Cincinnati,St. Louis,12/18/2011,Jerome Boger,21,210,11,101,10,109,22,15,2011
Miami,Buffalo,12/18/2011,John Parry,16,154,5,62,11,92,21,15,2011
Tennessee,Indianapolis,12/18/2011,Pete Morelli,11,95,7,70,4,25,11,15,2011
Washington,N.Y. Giants,12/18/2011,Al Riveron,10,123,2,48,8,75,11,15,2011
Seattle,Chicago,12/18/2011,Ed Hochuli,10,76,5,31,5,45,12,15,2011
New Orleans,Minnesota,12/18/2011,Walt Anderson,14,149,6,65,8,84,18,15,2011
Carolina,Houston,12/18/2011,Jeff Triplette,13,100,7,40,6,60,13,15,2011
Green Bay,Kansas City,12/18/2011,Gene Steratore,12,90,5,35,7,55,14,15,2011
Detroit,Oakland,12/18/2011,Bill Leavy,19,158,9,72,10,86,19,15,2011
N.Y. Jets,Philadelphia,12/18/2011,Clete Blakeman,18,155,11,93,7,62,18,15,2011
Cleveland,Arizona,12/18/2011,Scott Green,11,87,9,74,2,13,12,15,2011
New England,Denver,12/18/2011,Mike Carey,11,69,4,30,7,39,14,15,2011
Baltimore,San Diego,12/18/2011,Carl Cheffers,6,60,3,25,3,35,7,15,2011
Pittsburgh,San Francisco,12/19/2011,Walt Coleman,16,121,9,72,7,49,18,15,2011
Houston,Indianapolis,12/22/2011,Jerome Boger,15,119,11,84,4,35,18,16,2011
Denver,Buffalo,12/24/2011,Walt Anderson,15,127,7,58,8,69,15,16,2011
Miami,New England,12/24/2011,Al Riveron,11,89,6,39,5,50,11,16,2011
Cleveland,Baltimore,12/24/2011,Walt Coleman,11,146,6,95,5,51,11,16,2011
Jacksonville,Tennessee,12/24/2011,Gene Steratore,6,28,6,28,0,0,6,16,2011
Oakland,Kansas City,12/24/2011,Mike Carey,26,180,15,92,11,88,30,16,2011
N.Y. Giants,N.Y. Jets,12/24/2011,Pete Morelli,15,140,5,45,10,95,15,16,2011
Minnesota,Washington,12/24/2011,Tony Corrente,12,104,4,40,8,64,16,16,2011
Tampa Bay,Carolina,12/24/2011,Carl Cheffers,15,141,7,64,8,77,17,16,2011
Arizona,Cincinnati,12/24/2011,Terry McAulay,12,134,6,87,6,47,17,16,2011
St. Louis,Pittsburgh,12/24/2011,Clete Blakeman,11,71,4,21,7,50,14,16,2011
San Diego,Detroit,12/24/2011,Ed Hochuli,4,18,1,10,3,8,5,16,2011
Philadelphia,Dallas,12/24/2011,Bill Leavy,11,94,5,47,6,47,12,16,2011
San Francisco,Seattle,12/24/2011,Ron Winter,12,128,6,77,6,51,14,16,2011
Chicago,Green Bay,12/25/2011,John Parry,6,28,6,28,0,0,9,16,2011
Atlanta,New Orleans,12/26/2011,Jeff Triplette,11,103,7,57,4,46,12,16,2011
N.Y. Jets,Miami,01/01/2012,Jerome Boger,11,75,6,40,5,35,11,17,2011
Buffalo,New England,01/01/2012,Bill Leavy,9,122,5,45,4,77,13,17,2011
Baltimore,Cincinnati,01/01/2012,Tony Corrente,11,94,7,59,4,35,13,17,2011
Pittsburgh,Cleveland,01/01/2012,Al Riveron,9,77,4,37,5,40,11,17,2011
Tennessee,Houston,01/01/2012,Ron Winter,13,102,6,47,7,55,17,17,2011
Indianapolis,Jacksonville,01/01/2012,John Parry,5,50,4,40,1,10,6,17,2011
Dallas,N.Y. Giants,01/01/2012,Walt Anderson,10,71,7,43,3,28,10,17,2011
Washington,Philadelphia,01/01/2012,Carl Cheffers,14,146,6,71,8,75,16,17,2011
Detroit,Green Bay,01/01/2012,Walt Coleman,17,179,11,101,6,78,22,17,2011
Chicago,Minnesota,01/01/2012,Mike Carey,9,58,4,20,5,38,11,17,2011
Tampa Bay,Atlanta,01/01/2012,Scott Green,5,40,2,20,3,20,9,17,2011
Carolina,New Orleans,01/01/2012,Ed Hochuli,7,65,1,5,6,60,7,17,2011
San Francisco,St. Louis,01/01/2012,Jeff Triplette,11,130,5,80,6,50,14,17,2011
Kansas City,Denver,01/01/2012,Pete Morelli,12,85,6,36,6,49,14,17,2011
San Diego,Oakland,01/01/2012,Clete Blakeman,16,132,8,68,8,64,18,17,2011
Seattle,Arizona,01/01/2012,Gene Steratore,16,131,7,55,9,76,18,17,2011
Dallas,N.Y. Giants,09/05/2012,Jim Core,17,119,13,86,4,33,19,1,2012
Indianapolis,Chicago,09/09/2012,Wayne Elliott,10,67,3,19,7,48,12,1,2012
Jacksonville,Minnesota,09/09/2012,Robert Dalton,9,65,4,25,5,40,10,1,2012
Buffalo,N.Y. Jets,09/09/2012,Robert Frazer,11,68,6,34,5,34,13,1,2012
Miami,Houston,09/09/2012,Don King,11,113,7,78,4,35,11,1,2012
New England,Tennessee,09/09/2012,Jerry Frump,6,50,3,20,3,30,7,1,2012
St. Louis,Detroit,09/09/2012,Donovan Briggans,10,92,7,65,3,27,10,1,2012
Washington,New Orleans,09/09/2012,David Scott,24,234,12,127,12,107,25,1,2012
Philadelphia,Cleveland,09/09/2012,Kent Roan,15,145,12,110,3,35,19,1,2012
Atlanta,Kansas City,09/09/2012,Mike Shepherd,4,37,2,12,2,25,6,1,2012
San Francisco,Green Bay,09/09/2012,David White,18,143,8,66,10,77,18,1,2012
Seattle,Arizona,09/09/2012,Bruce Hermansen,23,192,13,90,10,102,26,1,2012
Carolina,Tampa Bay,09/09/2012,Jerry Hughes,10,100,6,65,4,35,10,1,2012
Pittsburgh,Denver,09/09/2012,Gerald Wright,14,101,8,52,6,49,17,1,2012
Cincinnati,Baltimore,09/10/2012,"Richard ""Matt"" Nicks",9,91,3,41,6,50,9,1,2012
San Diego,Oakland,09/10/2012,Jim Core,15,113,9,78,6,35,15,1,2012
Chicago,Green Bay,09/13/2012,Gerald Wright,12,119,8,65,4,54,12,2,2012
Tampa Bay,N.Y. Giants,09/16/2012,Jim Core,12,86,5,33,7,53,15,2,2012
New Orleans,Carolina,09/16/2012,Gerald Wright,6,57,2,23,4,34,6,2,2012
Arizona,New England,09/16/2012,David Scott,13,99,5,39,8,60,14,2,2012
Minnesota,Indianapolis,09/16/2012,Don King,18,156,11,105,7,51,19,2,2012
Baltimore,Philadelphia,09/16/2012,Robert Frazer,13,103,6,45,7,58,18,2,2012
Kansas City,Buffalo,09/16/2012,Robert Dalton,9,83,4,33,5,50,13,2,2012
Cleveland,Cincinnati,09/16/2012,Jerry Hughes,16,157,10,103,6,54,18,2,2012
Houston,Jacksonville,09/16/2012,David White,18,135,10,64,8,71,18,2,2012
Dallas,Seattle,09/16/2012,Donovan Briggans,10,82,5,47,5,35,11,2,2012
Washington,St. Louis,09/16/2012,Wayne Elliott,18,156,11,96,7,60,19,2,2012
N.Y. Jets,Pittsburgh,09/16/2012,Jerry Frump,17,170,7,63,10,107,19,2,2012
Tennessee,San Diego,09/16/2012,Bruce Hermansen,12,100,8,59,4,41,15,2,2012
Oakland,Miami,09/16/2012,Mike Shepherd,8,63,5,42,3,21,11,2,2012
Detroit,San Francisco,09/16/2012,"Richard ""Matt"" Nicks",13,129,8,67,5,62,13,2,2012
Denver,Atlanta,09/17/2012,Kent Roan,18,168,10,96,8,72,20,2,2012
N.Y. Giants,Carolina,09/20/2012,Robert Frazer,8,60,5,38,3,22,10,3,2012
Tampa Bay,Dallas,09/23/2012,Robert Dalton,23,174,10,69,13,105,26,3,2012
St. Louis,Chicago,09/23/2012,Jerry Hughes,10,85,4,40,6,45,13,3,2012
San Francisco,Minnesota,09/23/2012,Kent Roan,7,70,6,60,1,10,7,3,2012
Detroit,Tennessee,09/23/2012,Gerald Wright,16,123,10,91,6,32,20,3,2012
Cincinnati,Washington,09/23/2012,"Richard ""Matt"" Nicks",14,140,8,80,6,60,16,3,2012
Kansas City,New Orleans,09/23/2012,Don King,10,85,6,40,4,45,11,3,2012
N.Y. Jets,Miami,09/23/2012,Robert Frazer,20,173,9,108,11,65,22,3,2012
Buffalo,Cleveland,09/23/2012,David Scott,16,132,10,75,6,57,17,3,2012
Jacksonville,Indianapolis,09/23/2012,Donovan Briggans,17,173,5,52,12,121,21,3,2012
Philadelphia,Arizona,09/23/2012,Mike Shepherd,10,110,5,65,5,45,11,3,2012
Atlanta,San Diego,09/23/2012,Jim Core,6,32,2,15,4,17,6,3,2012
Houston,Denver,09/23/2012,Jerry Frump,16,144,9,69,7,75,17,3,2012
Pittsburgh,Oakland,09/23/2012,David White,13,106,10,81,3,25,14,3,2012
New England,Baltimore,09/23/2012,Bruce Hermansen,24,218,10,83,14,135,25,3,2012
Green Bay,Seattle,09/24/2012,Wayne Elliott,24,245,10,127,14,118,28,3,2012
Cleveland,Baltimore,09/27/2012,Gene Steratore,18,166,7,66,11,100,21,4,2012
New England,Buffalo,09/30/2012,John Parry,4,27,1,10,3,17,7,4,2012
Tennessee,Houston,09/30/2012,Carl Cheffers,8,76,7,73,1,3,12,4,2012
San Diego,Kansas City,09/30/2012,Bill Leavy,16,155,7,75,9,80,18,4,2012
Minnesota,Detroit,09/30/2012,Clete Blakeman,10,159,5,87,5,72,11,4,2012
Carolina,Atlanta,09/30/2012,Walt Coleman,11,79,9,64,2,15,15,4,2012
Seattle,St. Louis,09/30/2012,Mike Carey,11,92,5,55,6,37,15,4,2012
San Francisco,N.Y. Jets,09/30/2012,Tony Corrente,12,97,8,67,4,30,12,4,2012
Miami,Arizona,09/30/2012,Scott Green,10,102,4,40,6,62,12,4,2012
Oakland,Denver,09/30/2012,Pete Morelli,9,71,5,41,4,30,9,4,2012
Cincinnati,Jacksonville,09/30/2012,Ed Hochuli,9,87,6,50,3,37,9,4,2012
New Orleans,Green Bay,09/30/2012,Jeff Triplette,17,115,10,72,7,43,19,4,2012
Washington,Tampa Bay,09/30/2012,Al Riveron,18,180,8,73,10,107,19,4,2012
N.Y. Giants,Philadelphia,09/30/2012,Ron Winter,12,104,7,55,5,49,13,4,2012
Chicago,Dallas,10/01/2012,Walt Anderson,6,35,4,25,2,10,6,4,2012
Arizona,St. Louis,10/04/2012,John Parry,12,95,5,35,7,60,14,5,2012
Atlanta,Washington,10/07/2012,Bill Leavy,6,33,2,13,4,20,9,5,2012
Philadelphia,Pittsburgh,10/07/2012,Tony Corrente,14,141,5,35,9,106,17,5,2012
Green Bay,Indianapolis,10/07/2012,Walt Anderson,18,189,9,89,9,100,25,5,2012
Cleveland,N.Y. Giants,10/07/2012,Clete Blakeman,13,116,10,91,3,25,16,5,2012
Tennessee,Minnesota,10/07/2012,Jeff Triplette,15,135,10,75,5,60,16,5,2012
Miami,Cincinnati,10/07/2012,Walt Coleman,7,56,2,10,5,46,9,5,2012
Baltimore,Kansas City,10/07/2012,Pete Morelli,13,93,5,33,8,60,16,5,2012
Seattle,Carolina,10/07/2012,Terry McAulay,10,90,7,65,3,25,11,5,2012
Chicago,Jacksonville,10/07/2012,Ron Winter,18,129,12,80,6,49,18,5,2012
Denver,New England,10/07/2012,Gene Steratore,10,80,4,21,6,59,12,5,2012
Buffalo,San Francisco,10/07/2012,Jerome Boger,12,83,5,30,7,53,14,5,2012
San Diego,New Orleans,10/07/2012,Carl Cheffers,17,155,7,56,10,99,19,5,2012
Houston,N.Y. Jets,10/08/2012,Scott Green,12,75,7,50,5,25,14,5,2012
Pittsburgh,Tennessee,10/11/2012,Ed Hochuli,9,95,4,50,5,45,13,6,2012
Oakland,Atlanta,10/14/2012,Terry McAulay,14,135,12,110,2,25,17,6,2012
Kansas City,Tampa Bay,10/14/2012,Walt Coleman,13,88,7,55,6,33,15,6,2012
Indianapolis,N.Y. Jets,10/14/2012,Bill Leavy,11,137,3,27,8,110,12,6,2012
Cincinnati,Cleveland,10/14/2012,Pete Morelli,12,85,7,50,5,35,14,6,2012
Detroit,Philadelphia,10/14/2012,Bill Vinovich,25,192,16,132,9,60,29,6,2012
St. Louis,Miami,10/14/2012,Gene Steratore,17,134,12,94,5,40,18,6,2012
Dallas,Baltimore,10/14/2012,Mike Carey,23,158,13,82,10,76,25,6,2012
Buffalo,Arizona,10/14/2012,Al Riveron,12,106,5,39,7,67,13,6,2012
New England,Seattle,10/14/2012,Clete Blakeman,10,115,6,80,4,35,15,6,2012
N.Y. Giants,San Francisco,10/14/2012,John Parry,8,55,2,20,6,35,9,6,2012
Minnesota,Washington,10/14/2012,Tony Corrente,12,95,5,29,7,66,12,6,2012
Green Bay,Houston,10/14/2012,Jerome Boger,11,120,4,51,7,69,14,6,2012
Denver,San Diego,10/15/2012,Jeff Triplette,19,145,10,81,9,64,20,6,2012
Seattle,San Francisco,10/18/2012,Walt Anderson,8,60,3,20,5,40,11,7,2012
Washington,N.Y. Giants,10/21/2012,Ed Hochuli,10,85,7,55,3,30,10,7,2012
Arizona,Minnesota,10/21/2012,Terry McAulay,16,117,9,82,7,35,18,7,2012
Dallas,Carolina,10/21/2012,Ron Winter,15,114,6,43,9,71,16,7,2012
New Orleans,Tampa Bay,10/21/2012,Jerome Boger,14,110,7,55,7,55,19,7,2012
Green Bay,St. Louis,10/21/2012,Bill Vinovich,9,60,3,30,6,30,15,7,2012
Baltimore,Houston,10/21/2012,Tony Corrente,10,116,5,56,5,60,11,7,2012
Cleveland,Indianapolis,10/21/2012,Carl Cheffers,16,125,9,75,7,50,16,7,2012
Tennessee,Buffalo,10/21/2012,Mike Carey,11,90,3,25,8,65,11,7,2012
N.Y. Jets,New England,10/21/2012,Jeff Triplette,14,100,8,60,6,40,17,7,2012
Jacksonville,Oakland,10/21/2012,Scott Green,15,150,6,92,9,58,15,7,2012
Pittsburgh,Cincinnati,10/21/2012,Clete Blakeman,7,70,5,50,2,20,10,7,2012
Detroit,Chicago,10/22/2012,Al Riveron,14,96,5,47,9,49,16,7,2012
Tampa Bay,Minnesota,10/25/2012,Ron Winter,9,81,4,49,5,32,12,8,2012
Jacksonville,Green Bay,10/28/2012,Carl Cheffers,12,110,7,77,5,33,12,8,2012
Miami,N.Y. Jets,10/28/2012,Walt Anderson,9,76,4,31,5,45,10,8,2012
San Diego,Cleveland,10/28/2012,Jerome Boger,7,50,3,15,4,35,7,8,2012
Indianapolis,Tennessee,10/28/2012,Al Riveron,13,110,5,45,8,65,15,8,2012
New England,St. Louis,10/28/2012,Walt Coleman,20,144,8,42,12,102,21,8,2012
Atlanta,Philadelphia,10/28/2012,Gene Steratore,12,97,6,40,6,57,17,8,2012
Carolina,Chicago,10/28/2012,Ed Hochuli,8,61,3,21,5,40,11,8,2012
Seattle,Detroit,10/28/2012,John Parry,7,71,2,10,5,61,11,8,2012
Washington,Pittsburgh,10/28/2012,Pete Morelli,10,75,7,55,3,20,14,8,2012
Oakland,Kansas City,10/28/2012,Bill Vinovich,7,60,2,20,5,40,9,8,2012
N.Y. Giants,Dallas,10/28/2012,Scott Green,8,55,5,45,3,10,11,8,2012
New Orleans,Denver,10/28/2012,Mike Carey,8,49,3,15,5,34,12,8,2012
San Francisco,Arizona,10/29/2012,Bill Leavy,17,131,10,80,7,51,18,8,2012
Kansas City,San Diego,11/01/2012,Al Riveron,13,91,5,37,8,54,14,9,2012
Carolina,Washington,11/04/2012,Carl Cheffers,20,157,7,60,13,97,22,9,2012
Arizona,Green Bay,11/04/2012,Walt Coleman,9,62,8,57,1,5,9,9,2012
Detroit,Jacksonville,11/04/2012,Gene Steratore,8,82,5,42,3,40,11,9,2012
Chicago,Tennessee,11/04/2012,Terry McAulay,14,105,5,37,9,68,16,9,2012
Denver,Cincinnati,11/04/2012,Scott Green,13,112,5,29,8,83,14,9,2012
Baltimore,Cleveland,11/04/2012,Jeff Triplette,13,113,9,82,4,31,18,9,2012
Buffalo,Houston,11/04/2012,Bill Vinovich,10,57,3,15,7,42,11,9,2012
Miami,Indianapolis,11/04/2012,Tony Corrente,19,170,8,79,11,91,23,9,2012
Minnesota,Seattle,11/04/2012,Jerome Boger,10,82,6,33,4,49,11,9,2012
Tampa Bay,Oakland,11/04/2012,Walt Anderson,23,196,14,116,9,80,25,9,2012
Pittsburgh,N.Y. Giants,11/04/2012,Bill Leavy,13,159,6,119,7,40,13,9,2012
Dallas,Atlanta,11/04/2012,John Parry,9,65,7,50,2,15,12,9,2012
Philadelphia,New Orleans,11/05/2012,Clete Blakeman,11,93,7,58,4,35,12,9,2012
Indianapolis,Jacksonville,11/08/2012,Terry McAulay,16,155,6,40,10,115,19,10,2012
Denver,Carolina,11/11/2012,Al Riveron,14,105,7,60,7,45,15,10,2012
San Diego,Tampa Bay,11/11/2012,Bill Vinovich,2,10,1,5,1,5,2,10,2012
Tennessee,Miami,11/11/2012,Walt Anderson,11,106,4,39,7,67,13,10,2012
Buffalo,New England,11/11/2012,Bill Leavy,21,221,14,148,7,73,22,10,2012
Oakland,Baltimore,11/11/2012,Ron Winter,14,146,10,105,4,41,16,10,2012
N.Y. Giants,Cincinnati,11/11/2012,Mike Carey,6,45,1,5,5,40,6,10,2012
Atlanta,New Orleans,11/11/2012,Tony Corrente,11,88,6,53,5,35,12,10,2012
Detroit,Minnesota,11/11/2012,Pete Morelli,13,104,6,57,7,47,13,10,2012
N.Y. Jets,Seattle,11/11/2012,Ed Hochuli,13,80,6,35,7,45,16,10,2012
Dallas,Philadelphia,11/11/2012,Walt Coleman,19,125,13,75,6,50,20,10,2012
St. Louis,San Francisco,11/11/2012,Clete Blakeman,20,151,13,85,7,66,22,10,2012
Houston,Chicago,11/11/2012,Gene Steratore,8,84,3,35,5,49,10,10,2012
Kansas City,Pittsburgh,11/12/2012,Carl Cheffers,8,95,6,76,2,19,10,10,2012
Miami,Buffalo,11/15/2012,Jeff Triplette,17,169,11,100,6,69,17,11,2012
Philadelphia,Washington,11/18/2012,Terry McAulay,22,150,9,70,13,80,25,11,2012
Green Bay,Detroit,11/18/2012,Ron Winter,16,130,9,80,7,50,19,11,2012
Arizona,Atlanta,11/18/2012,Bill Vinovich,10,78,5,43,5,35,11,11,2012
Tampa Bay,Carolina,11/18/2012,Bill Leavy,17,141,6,50,11,91,18,11,2012
Cleveland,Dallas,11/18/2012,Ed Hochuli,21,221,12,129,9,92,21,11,2012
N.Y. Jets,St. Louis,11/18/2012,Jerome Boger,8,50,3,20,5,30,10,11,2012
Indianapolis,New England,11/18/2012,John Parry,5,75,1,5,4,70,9,11,2012
Jacksonville,Houston,11/18/2012,Clete Blakeman,8,74,6,54,2,20,10,11,2012
Cincinnati,Kansas City,11/18/2012,Gene Steratore,14,84,9,54,5,30,15,11,2012
New Orleans,Oakland,11/18/2012,Pete Morelli,11,114,7,74,4,40,11,11,2012
San Diego,Denver,11/18/2012,Carl Cheffers,14,95,10,65,4,30,14,11,2012
Baltimore,Pittsburgh,11/18/2012,Walt Anderson,10,111,4,68,6,43,11,11,2012
Chicago,San Francisco,11/19/2012,Tony Corrente,11,105,6,55,5,50,11,11,2012
Houston,Detroit,11/22/2012,Walt Coleman,15,135,8,65,7,70,15,12,2012
Washington,Dallas,11/22/2012,Bill Leavy,12,86,5,41,7,45,14,12,2012
New England,N.Y. Jets,11/22/2012,Mike Carey,13,71,8,36,5,35,13,12,2012
Oakland,Cincinnati,11/25/2012,Al Riveron,6,50,3,25,3,25,7,12,2012
Pittsburgh,Cleveland,11/25/2012,Ron Winter,19,158,9,68,10,90,20,12,2012
Buffalo,Indianapolis,11/25/2012,Ed Hochuli,10,83,4,46,6,37,12,12,2012
Tennessee,Jacksonville,11/25/2012,Walt Anderson,11,72,6,42,5,30,12,12,2012
Denver,Kansas City,11/25/2012,Jerome Boger,11,85,4,35,7,50,13,12,2012
Minnesota,Chicago,11/25/2012,Scott Green,8,99,3,44,5,55,8,12,2012
Atlanta,Tampa Bay,11/25/2012,Jeff Triplette,7,39,2,15,5,24,9,12,2012
Seattle,Miami,11/25/2012,Clete Blakeman,12,74,10,59,2,15,13,12,2012
Baltimore,San Diego,11/25/2012,Gene Steratore,11,97,6,60,5,37,13,12,2012
San Francisco,New Orleans,11/25/2012,John Parry,14,121,10,68,4,53,16,12,2012
St. Louis,Arizona,11/25/2012,Tony Corrente,17,140,10,84,7,56,20,12,2012
Green Bay,N.Y. Giants,11/25/2012,Terry McAulay,11,73,7,49,4,24,14,12,2012
Carolina,Philadelphia,11/26/2012,Pete Morelli,11,131,6,101,5,30,15,12,2012
New Orleans,Atlanta,11/29/2012,Scott Green,10,55,5,30,5,25,10,13,2012
Seattle,Chicago,12/02/2012,Mike Carey,13,100,8,55,5,45,14,13,2012
Minnesota,Green Bay,12/02/2012,Ed Hochuli,15,126,5,48,10,78,20,13,2012
San Francisco,St. Louis,12/02/2012,Carl Cheffers,18,157,11,97,7,60,20,13,2012
Arizona,N.Y. Jets,12/02/2012,Walt Anderson,7,50,4,30,3,20,8,13,2012
Carolina,Kansas City,12/02/2012,John Parry,8,50,7,45,1,5,8,13,2012
Indianapolis,Detroit,12/02/2012,Bill Vinovich,12,97,4,36,8,61,15,13,2012
Jacksonville,Buffalo,12/02/2012,Pete Morelli,17,174,8,74,9,100,18,13,2012
New England,Miami,12/02/2012,Ron Winter,14,142,6,50,8,92,15,13,2012
Houston,Tennessee,12/02/2012,Tony Corrente,15,132,11,97,4,35,18,13,2012
Tampa Bay,Denver,12/02/2012,Terry McAulay,19,155,11,80,8,75,20,13,2012
Pittsburgh,Baltimore,12/02/2012,Al Riveron,12,120,4,50,8,70,12,13,2012
Cleveland,Oakland,12/02/2012,Bill Leavy,12,90,2,25,10,65,12,13,2012
Cincinnati,San Diego,12/02/2012,Walt Coleman,16,110,8,55,8,55,18,13,2012
Philadelphia,Dallas,12/02/2012,Jeff Triplette,8,65,1,5,7,60,11,13,2012
N.Y. Giants,Washington,12/03/2012,Jerome Boger,13,129,9,73,4,56,16,13,2012
Denver,Oakland,12/06/2012,Clete Blakeman,14,119,3,25,11,94,17,14,2012
Baltimore,Washington,12/09/2012,John Parry,16,126,8,56,8,70,16,14,2012
Kansas City,Cleveland,12/09/2012,Walt Anderson,12,90,5,35,7,55,12,14,2012
San Diego,Pittsburgh,12/09/2012,Scott Green,14,103,6,51,8,52,15,14,2012
Tennessee,Indianapolis,12/09/2012,Pete Morelli,15,113,9,70,6,43,17,14,2012
N.Y. Jets,Jacksonville,12/09/2012,Al Riveron,8,69,1,15,7,54,8,14,2012
Chicago,Minnesota,12/09/2012,Walt Coleman,17,134,10,80,7,54,21,14,2012
Atlanta,Carolina,12/09/2012,Ed Hochuli,6,25,3,15,3,10,6,14,2012
Philadelphia,Tampa Bay,12/09/2012,Ron Winter,10,73,2,13,8,60,14,14,2012
St. Louis,Buffalo,12/09/2012,Gene Steratore,4,32,2,17,2,15,6,14,2012
Dallas,Cincinnati,12/09/2012,Bill Vinovich,14,119,6,49,8,70,16,14,2012
Miami,San Francisco,12/09/2012,Mike Carey,11,88,5,43,6,45,12,14,2012
New Orleans,N.Y. Giants,12/09/2012,Jeff Triplette,16,136,10,81,6,55,19,14,2012
Arizona,Seattle,12/09/2012,Carl Cheffers,19,176,9,79,10,97,22,14,2012
Detroit,Green Bay,12/09/2012,Tony Corrente,12,105,5,55,7,50,13,14,2012
Houston,New England,12/10/2012,Terry McAulay,13,126,7,70,6,56,17,14,2012
Cincinnati,Philadelphia,12/13/2012,Carl Cheffers,20,170,11,94,9,76,25,15,2012
Green Bay,Chicago,12/16/2012,Walt Anderson,18,195,8,104,10,91,22,15,2012
N.Y. Giants,Atlanta,12/16/2012,Bill Leavy,5,55,2,25,3,30,10,15,2012
Tampa Bay,New Orleans,12/16/2012,Mike Carey,13,139,7,84,6,55,14,15,2012
Minnesota,St. Louis,12/16/2012,Al Riveron,11,96,3,49,8,47,15,15,2012
Washington,Cleveland,12/16/2012,Bill Vinovich,11,75,6,45,5,30,12,15,2012
Jacksonville,Miami,12/16/2012,John Parry,15,129,10,88,5,41,17,15,2012
Denver,Baltimore,12/16/2012,Pete Morelli,13,112,7,51,6,61,13,15,2012
Indianapolis,Houston,12/16/2012,Jeff Triplette,17,148,8,79,9,69,24,15,2012
Detroit,Arizona,12/16/2012,Jerome Boger,13,113,7,63,6,50,15,15,2012
Carolina,San Diego,12/16/2012,Terry McAulay,15,118,6,48,9,70,17,15,2012
Seattle,Buffalo,12/16/2012,Scott Green,8,52,4,32,4,20,9,15,2012
Pittsburgh,Dallas,12/16/2012,Clete Blakeman,8,61,0,0,8,61,8,15,2012
Kansas City,Oakland,12/16/2012,Tony Corrente,12,122,7,60,5,62,14,15,2012
San Francisco,New England,12/16/2012,Ed Hochuli,14,161,6,88,8,73,16,15,2012
N.Y. Jets,Tennessee,12/17/2012,Walt Coleman,18,134,4,23,14,111,20,15,2012
Atlanta,Detroit,12/22/2012,Gene Steratore,5,40,3,20,2,20,9,16,2012
Tennessee,Green Bay,12/23/2012,Clete Blakeman,6,45,5,35,1,10,10,16,2012
Oakland,Carolina,12/23/2012,Jerome Boger,16,167,6,70,10,97,22,16,2012
Buffalo,Miami,12/23/2012,Walt Anderson,14,118,11,93,3,25,14,16,2012
Cincinnati,Pittsburgh,12/23/2012,Mike Carey,12,118,7,55,5,63,14,16,2012
New England,Jacksonville,12/23/2012,Jeff Triplette,9,86,4,39,5,47,11,16,2012
Indianapolis,Kansas City,12/23/2012,Ron Winter,13,123,4,48,9,75,13,16,2012
New Orleans,Dallas,12/23/2012,Walt Coleman,11,74,6,42,5,32,14,16,2012
Washington,Philadelphia,12/23/2012,Ed Hochuli,7,54,3,24,4,30,10,16,2012
St. Louis,Tampa Bay,12/23/2012,Scott Green,10,69,9,64,1,5,10,16,2012
N.Y. Giants,Baltimore,12/23/2012,Carl Cheffers,15,144,6,52,9,92,16,16,2012
Minnesota,Houston,12/23/2012,John Parry,14,112,5,52,9,60,15,16,2012
Cleveland,Denver,12/23/2012,Al Riveron,21,153,10,69,11,84,26,16,2012
Chicago,Arizona,12/23/2012,Terry McAulay,6,37,2,12,4,25,8,16,2012
San Francisco,Seattle,12/23/2012,Bill Vinovich,10,103,6,58,4,45,12,16,2012
San Diego,N.Y. Jets,12/23/2012,Pete Morelli,11,93,5,53,6,40,11,16,2012
N.Y. Jets,Buffalo,12/30/2012,Terry McAulay,8,69,4,45,4,24,11,17,2012
Miami,New England,12/30/2012,Jerome Boger,9,71,3,23,6,48,9,17,2012
Baltimore,Cincinnati,12/30/2012,Ron Winter,14,142,10,102,4,40,14,17,2012
Cleveland,Pittsburgh,12/30/2012,Walt Coleman,12,137,9,79,3,58,13,17,2012
Houston,Indianapolis,12/30/2012,Clete Blakeman,12,88,9,64,3,24,15,17,2012
Jacksonville,Tennessee,12/30/2012,Bill Vinovich,12,78,7,35,5,43,15,17,2012
Philadelphia,N.Y. Giants,12/30/2012,Tony Corrente,7,57,6,52,1,5,10,17,2012
Dallas,Washington,12/30/2012,Walt Anderson,3,26,1,6,2,20,5,17,2012
Chicago,Detroit,12/30/2012,Bill Leavy,7,64,3,35,4,29,8,17,2012
Green Bay,Minnesota,12/30/2012,Mike Carey,17,141,7,43,10,98,18,17,2012
Tampa Bay,Atlanta,12/30/2012,Carl Cheffers,4,30,2,15,2,15,6,17,2012
Carolina,New Orleans,12/30/2012,Al Riveron,9,91,4,36,5,55,13,17,2012
Kansas City,Denver,12/30/2012,Ed Hochuli,10,62,5,32,5,30,11,17,2012
Oakland,San Diego,12/30/2012,John Parry,17,127,9,67,8,60,19,17,2012
Arizona,San Francisco,12/30/2012,Pete Morelli,8,59,5,34,3,25,8,17,2012
St. Louis,Seattle,12/30/2012,Jeff Triplette,24,178,14,98,10,80,28,17,2012
Baltimore,Denver,09/05/2013,Walt Coleman,15,114,7,53,8,61,21,1,2013
New England,Buffalo,09/08/2013,Walt Anderson,14,111,4,36,10,75,17,1,2013
Seattle,Carolina,09/08/2013,Jeff Triplette,13,155,9,109,4,46,15,1,2013
Cincinnati,Chicago,09/08/2013,Carl Cheffers,12,143,8,84,4,59,12,1,2013
Miami,Cleveland,09/08/2013,Mike Carey,19,134,10,77,9,57,20,1,2013
Minnesota,Detroit,09/08/2013,John Parry,16,140,5,52,11,88,17,1,2013
Oakland,Indianapolis,09/08/2013,Bill Vinovich,11,82,8,51,3,31,13,1,2013
Kansas City,Jacksonville,09/08/2013,Pete Morelli,8,50,3,20,5,30,8,1,2013
Tampa Bay,N.Y. Jets,09/08/2013,Ed Hochuli,19,147,13,102,6,45,22,1,2013
Atlanta,New Orleans,09/08/2013,Gene Steratore,8,76,2,19,6,57,8,1,2013
Tennessee,Pittsburgh,09/08/2013,Jerome Boger,10,107,6,60,4,47,11,1,2013
Arizona,St. Louis,09/08/2013,Clete Blakeman,13,127,6,68,7,59,15,1,2013
Green Bay,San Francisco,09/08/2013,Bill Leavy,16,129,5,44,11,85,17,1,2013
N.Y. Giants,Dallas,09/08/2013,Tony Corrente,11,92,6,52,5,40,13,1,2013
Philadelphia,Washington,09/09/2013,Ron Winter,18,140,8,65,10,75,23,1,2013
Houston,San Diego,09/09/2013,Scott Green,14,128,7,73,7,55,16,1,2013
N.Y. Jets,New England,09/12/2013,Carl Cheffers,11,96,8,66,3,30,13,2,2013
St. Louis,Atlanta,09/15/2013,Scott Green,14,106,7,53,7,53,14,2,2013
Cleveland,Baltimore,09/15/2013,Bill Vinovich,8,74,5,33,3,41,9,2,2013
Carolina,Buffalo,09/15/2013,Walt Coleman,10,85,3,30,7,55,11,2,2013
Minnesota,Chicago,09/15/2013,Ed Hochuli,7,60,3,25,4,35,9,2,2013
Washington,Green Bay,09/15/2013,Tony Corrente,11,118,7,78,4,40,14,2,2013
Tennessee,Houston,09/15/2013,Jeff Triplette,14,110,9,70,5,40,16,2,2013
Miami,Indianapolis,09/15/2013,Clete Blakeman,3,13,0,0,3,13,4,2,2013
Dallas,Kansas City,09/15/2013,Jerome Boger,15,72,5,27,10,45,18,2,2013
San Diego,Philadelphia,09/15/2013,Terry McAulay,13,114,4,32,9,82,15,2,2013
Detroit,Arizona,09/15/2013,Pete Morelli,15,141,8,101,7,40,15,2,2013
New Orleans,Tampa Bay,09/15/2013,Bill Leavy,15,153,5,35,10,118,16,2,2013
Denver,N.Y. Giants,09/15/2013,Gene Steratore,17,148,13,132,4,16,18,2,2013
Jacksonville,Oakland,09/15/2013,Walt Anderson,15,100,10,70,5,30,18,2,2013
San Francisco,Seattle,09/15/2013,John Parry,22,205,12,121,10,84,23,2,2013
Pittsburgh,Cincinnati,09/16/2013,Mike Carey,12,113,3,29,9,84,13,2,2013
Kansas City,Philadelphia,09/19/2013,Walt Anderson,15,110,9,65,6,45,17,3,2013
Houston,Baltimore,09/22/2013,John Parry,24,200,14,113,10,87,26,3,2013
Green Bay,Cincinnati,09/22/2013,Clete Blakeman,9,98,4,55,5,43,12,3,2013
St. Louis,Dallas,09/22/2013,Carl Cheffers,11,113,5,41,6,72,16,3,2013
Atlanta,Miami,09/22/2013,Ron Winter,9,72,7,59,2,13,9,3,2013
Cleveland,Minnesota,09/22/2013,Bill Leavy,9,82,5,47,4,35,9,3,2013
Buffalo,N.Y. Jets,09/22/2013,Scott Green,27,255,7,87,20,168,31,3,2013
Tampa Bay,New England,09/22/2013,Jeff Triplette,10,98,4,48,6,50,13,3,2013
Arizona,New Orleans,09/22/2013,Walt Coleman,7,48,3,18,4,30,10,3,2013
San Diego,Tennessee,09/22/2013,Tony Corrente,16,161,5,45,11,116,19,3,2013
Detroit,Washington,09/22/2013,Ed Hochuli,14,116,8,71,6,45,16,3,2013
N.Y. Giants,Carolina,09/22/2013,Mike Carey,10,77,6,45,4,32,12,3,2013
Indianapolis,San Francisco,09/22/2013,Terry McAulay,7,58,1,10,6,48,7,3,2013
Jacksonville,Seattle,09/22/2013,Bill Vinovich,8,69,4,45,4,24,9,3,2013
Chicago,Pittsburgh,09/22/2013,Pete Morelli,9,84,3,25,6,59,10,3,2013
Oakland,Denver,09/23/2013,Jerome Boger,13,117,8,77,5,40,14,3,2013
San Francisco,St. Louis,09/26/2013,Jeff Triplette,18,167,10,85,8,82,21,4,2013
Baltimore,Buffalo,09/29/2013,Jerome Boger,19,158,8,59,11,99,21,4,2013
Cincinnati,Cleveland,09/29/2013,Ron Winter,8,105,3,25,5,80,11,4,2013
Chicago,Detroit,09/29/2013,Mike Carey,7,55,4,30,3,25,7,4,2013
Seattle,Houston,09/29/2013,Tony Corrente,15,148,9,62,6,86,17,4,2013
Indianapolis,Jacksonville,09/29/2013,John Parry,16,123,7,58,9,65,17,4,2013
N.Y. Giants,Kansas City,09/29/2013,Terry McAulay,14,127,7,65,7,62,14,4,2013
Pittsburgh,Minnesota,09/29/2013,Clete Blakeman,9,139,4,50,5,89,9,4,2013
Arizona,Tampa Bay,09/29/2013,Gene Steratore,18,163,10,90,8,73,19,4,2013
N.Y. Jets,Tennessee,09/29/2013,Walt Anderson,14,96,10,66,4,30,16,4,2013
Philadelphia,Denver,09/29/2013,Pete Morelli,10,87,8,62,2,25,11,4,2013
Washington,Oakland,09/29/2013,Bill Leavy,7,54,3,29,4,25,8,4,2013
Dallas,San Diego,09/29/2013,Ed Hochuli,12,118,5,33,7,85,15,4,2013
New England,Atlanta,09/29/2013,Walt Coleman,15,148,9,93,6,55,17,4,2013
Miami,New Orleans,09/30/2013,Bill Vinovich,11,70,5,25,6,45,11,4,2013
Buffalo,Cleveland,10/03/2013,Pete Morelli,13,122,7,56,6,66,14,5,2013
New Orleans,Chicago,10/06/2013,Scott Green,8,53,2,10,6,43,10,5,2013
New England,Cincinnati,10/06/2013,Gene Steratore,7,59,0,0,7,59,8,5,2013
Detroit,Green Bay,10/06/2013,Jerome Boger,17,122,7,50,10,72,20,5,2013
Seattle,Indianapolis,10/06/2013,Ron Winter,10,120,7,85,3,35,12,5,2013
Baltimore,Miami,10/06/2013,Carl Cheffers,10,129,6,64,4,65,12,5,2013
Philadelphia,N.Y. Giants,10/06/2013,Walt Coleman,20,224,8,88,12,136,23,5,2013
Jacksonville,St. Louis,10/06/2013,Tony Corrente,10,98,4,45,6,53,10,5,2013
Kansas City,Tennessee,10/06/2013,Bill Vinovich,15,96,9,61,6,35,15,5,2013
Carolina,Arizona,10/06/2013,John Parry,12,109,9,79,3,30,14,5,2013
Denver,Dallas,10/06/2013,Terry McAulay,14,136,5,55,9,81,17,5,2013
San Diego,Oakland,10/06/2013,Jeff Triplette,13,115,5,30,8,85,18,5,2013
Houston,San Francisco,10/06/2013,Mike Carey,10,69,7,52,3,17,11,5,2013
N.Y. Jets,Atlanta,10/07/2013,Bill Leavy,10,70,6,24,4,46,11,5,2013
N.Y. Giants,Chicago,10/10/2013,John Parry,9,82,4,31,5,51,11,6,2013
Green Bay,Baltimore,10/13/2013,Gene Steratore,14,95,8,55,6,40,15,6,2013
Cincinnati,Buffalo,10/13/2013,Ed Hochuli,12,105,8,78,4,27,13,6,2013
Detroit,Cleveland,10/13/2013,Walt Coleman,17,152,8,65,9,87,18,6,2013
St. Louis,Houston,10/13/2013,Bill Leavy,16,169,9,74,7,95,17,6,2013
Oakland,Kansas City,10/13/2013,Mike Carey,15,88,11,68,4,20,17,6,2013
Carolina,Minnesota,10/13/2013,Ron Winter,11,95,6,40,5,55,13,6,2013
Pittsburgh,N.Y. Jets,10/13/2013,Terry McAulay,12,109,7,49,5,60,13,6,2013
Philadelphia,Tampa Bay,10/13/2013,Clete Blakeman,11,103,3,31,8,72,12,6,2013
Jacksonville,Denver,10/13/2013,Jeff Triplette,11,93,7,62,4,31,11,6,2013
Tennessee,Seattle,10/13/2013,Carl Cheffers,13,109,7,44,6,65,13,6,2013
New Orleans,New England,10/13/2013,Tony Corrente,11,89,7,56,4,33,14,6,2013
Arizona,San Francisco,10/13/2013,Scott Green,10,73,6,38,4,35,14,6,2013
Washington,Dallas,10/13/2013,Walt Anderson,19,184,12,104,7,80,20,6,2013
Indianapolis,San Diego,10/14/2013,Pete Morelli,10,53,5,28,5,25,11,6,2013
Seattle,Arizona,10/17/2013,Terry McAulay,13,92,10,70,3,22,16,7,2013
Tampa Bay,Atlanta,10/20/2013,Walt Anderson,20,204,11,103,9,101,23,7,2013
St. Louis,Carolina,10/20/2013,Bill Vinovich,15,127,8,68,7,59,16,7,2013
Cincinnati,Detroit,10/20/2013,Scott Green,10,80,6,50,4,30,13,7,2013
Cleveland,Green Bay,10/20/2013,Jeff Triplette,22,203,12,106,10,97,22,7,2013
San Diego,Jacksonville,10/20/2013,Walt Coleman,14,106,8,61,6,45,15,7,2013
Houston,Kansas City,10/20/2013,Ed Hochuli,9,64,4,40,5,24,11,7,2013
Buffalo,Miami,10/20/2013,Gene Steratore,10,85,6,53,4,32,11,7,2013
New England,N.Y. Jets,10/20/2013,Jerome Boger,16,145,7,100,9,45,18,7,2013
Dallas,Philadelphia,10/20/2013,John Parry,17,108,12,75,5,33,20,7,2013
Chicago,Washington,10/20/2013,Clete Blakeman,10,77,5,30,5,47,10,7,2013
San Francisco,Tennessee,10/20/2013,Ron Winter,15,142,5,42,10,100,19,7,2013
Baltimore,Pittsburgh,10/20/2013,Bill Leavy,16,117,9,67,7,50,18,7,2013
Denver,Indianapolis,10/20/2013,Carl Cheffers,18,155,12,103,6,52,25,7,2013
Minnesota,N.Y. Giants,10/21/2013,Tony Corrente,8,110,3,38,5,72,10,7,2013
Carolina,Tampa Bay,10/24/2013,Jerome Boger,9,80,6,59,3,21,10,8,2013
Dallas,Detroit,10/27/2013,Bill Vinovich,10,92,2,31,8,61,11,8,2013
San Francisco,Jacksonville,10/27/2013,Ed Hochuli,10,111,4,35,6,76,10,8,2013
Cleveland,Kansas City,10/27/2013,Clete Blakeman,14,101,9,70,5,31,16,8,2013
Miami,New England,10/27/2013,Walt Anderson,12,96,7,61,5,35,12,8,2013
Buffalo,New Orleans,10/27/2013,Terry McAulay,14,104,6,45,8,59,14,8,2013
N.Y. Giants,Philadelphia,10/27/2013,Carl Cheffers,15,140,11,92,4,48,16,8,2013
Pittsburgh,Oakland,10/27/2013,John Parry,9,51,3,12,6,39,11,8,2013
N.Y. Jets,Cincinnati,10/27/2013,Pete Morelli,8,114,4,69,4,45,9,8,2013
Atlanta,Arizona,10/27/2013,Mike Carey,18,107,10,55,8,52,19,8,2013
Washington,Denver,10/27/2013,Ron Winter,7,62,1,5,6,57,10,8,2013
Green Bay,Minnesota,10/27/2013,Scott Green,13,166,6,120,7,46,13,8,2013
Seattle,St. Louis,10/28/2013,Gene Steratore,18,136,10,83,8,53,21,8,2013
Cincinnati,Miami,10/31/2013,Bill Leavy,5,88,3,63,2,25,6,9,2013
Kansas City,Buffalo,11/03/2013,Ron Winter,11,86,5,38,6,48,12,9,2013
Atlanta,Carolina,11/03/2013,Tony Corrente,9,74,7,59,2,15,9,9,2013
Minnesota,Dallas,11/03/2013,Jeff Triplette,9,80,4,35,5,45,11,9,2013
New Orleans,N.Y. Jets,11/03/2013,Clete Blakeman,17,121,9,59,8,62,18,9,2013
Tennessee,St. Louis,11/03/2013,Pete Morelli,9,74,3,30,6,44,9,9,2013
San Diego,Washington,11/03/2013,Jerome Boger,14,128,7,63,7,65,15,9,2013
Philadelphia,Oakland,11/03/2013,Ed Hochuli,15,122,7,52,8,70,19,9,2013
Tampa Bay,Seattle,11/03/2013,Mike Carey,14,166,8,99,6,67,16,9,2013
Baltimore,Cleveland,11/03/2013,Scott Green,15,135,9,80,6,55,15,9,2013
Pittsburgh,New England,11/03/2013,Walt Coleman,11,126,8,96,3,30,12,9,2013
Indianapolis,Houston,11/03/2013,Bill Vinovich,8,101,3,15,5,86,9,9,2013
Chicago,Green Bay,11/04/2013,Walt Anderson,4,45,4,45,0,0,5,9,2013
Washington,Minnesota,11/07/2013,Ed Hochuli,9,70,8,63,1,7,10,10,2013
Seattle,Atlanta,11/10/2013,Bill Vinovich,10,95,9,80,1,15,11,10,2013
Cincinnati,Baltimore,11/10/2013,Walt Coleman,17,199,9,134,8,65,18,10,2013
Detroit,Chicago,11/10/2013,Bill Leavy,10,90,5,51,5,39,10,10,2013
Philadelphia,Green Bay,11/10/2013,Mike Carey,10,96,5,65,5,31,12,10,2013
St. Louis,Indianapolis,11/10/2013,Terry McAulay,10,66,8,46,2,20,11,10,2013
Oakland,N.Y. Giants,11/10/2013,Pete Morelli,9,70,8,65,1,5,11,10,2013
Buffalo,Pittsburgh,11/10/2013,Scott Green,10,72,4,30,6,42,13,10,2013
Jacksonville,Tennessee,11/10/2013,John Parry,10,64,4,19,6,45,12,10,2013
Carolina,San Francisco,11/10/2013,Carl Cheffers,7,50,3,25,4,25,9,10,2013
Houston,Arizona,11/10/2013,Gene Steratore,12,82,7,53,5,29,12,10,2013
Denver,San Diego,11/10/2013,Tony Corrente,9,68,3,28,6,40,9,10,2013
Dallas,New Orleans,11/10/2013,Jerome Boger,17,126,11,82,6,44,18,10,2013
Miami,Tampa Bay,11/11/2013,Jeff Triplette,13,140,4,70,9,70,13,10,2013
Indianapolis,Tennessee,11/14/2013,Mike Carey,9,85,5,51,4,34,12,11,2013
N.Y. Jets,Buffalo,11/17/2013,Bill Leavy,12,88,4,24,8,64,12,11,2013
Baltimore,Chicago,11/17/2013,Gene Steratore,18,157,5,46,13,111,21,11,2013
Cleveland,Cincinnati,11/17/2013,Carl Cheffers,13,104,5,40,8,64,15,11,2013
Oakland,Houston,11/17/2013,Ron Winter,17,127,8,77,9,50,21,11,2013
Arizona,Jacksonville,11/17/2013,Jeff Triplette,11,82,5,42,6,40,12,11,2013
San Diego,Miami,11/17/2013,Pete Morelli,13,91,10,76,3,15,13,11,2013
Washington,Philadelphia,11/17/2013,Walt Coleman,13,107,4,39,9,68,15,11,2013
Detroit,Pittsburgh,11/17/2013,Walt Anderson,12,68,8,45,4,23,14,11,2013
Atlanta,Tampa Bay,11/17/2013,Ed Hochuli,18,166,7,45,11,121,19,11,2013
Kansas City,Denver,11/17/2013,John Parry,22,135,9,53,13,82,23,11,2013
San Francisco,New Orleans,11/17/2013,Tony Corrente,9,93,5,45,4,48,10,11,2013
Minnesota,Seattle,11/17/2013,Jerome Boger,11,116,4,20,7,96,11,11,2013
Green Bay,N.Y. Giants,11/17/2013,Terry McAulay,8,68,5,38,3,30,13,11,2013
New England,Carolina,11/18/2013,Clete Blakeman,12,97,5,50,7,47,12,11,2013
New Orleans,Atlanta,11/21/2013,Ron Winter,8,91,5,66,3,25,10,12,2013
N.Y. Jets,Baltimore,11/24/2013,Jeff Triplette,11,97,6,56,5,41,12,12,2013
Pittsburgh,Cleveland,11/24/2013,Terry McAulay,4,18,2,8,2,10,5,12,2013
Tampa Bay,Detroit,11/24/2013,Clete Blakeman,14,106,9,67,5,39,16,12,2013
Minnesota,Green Bay,11/24/2013,Bill Vinovich,12,103,5,53,7,50,15,12,2013
Jacksonville,Houston,11/24/2013,Mike Carey,9,85,7,63,2,22,10,12,2013
San Diego,Kansas City,11/24/2013,Walt Coleman,16,159,9,97,7,62,17,12,2013
Carolina,Miami,11/24/2013,Scott Green,14,111,8,56,6,55,15,12,2013
Chicago,St. Louis,11/24/2013,Jerome Boger,16,123,10,84,6,39,19,12,2013
Indianapolis,Arizona,11/24/2013,Bill Leavy,15,173,6,89,9,84,15,12,2013
Tennessee,Oakland,11/24/2013,Carl Cheffers,14,150,10,100,4,50,14,12,2013
Dallas,N.Y. Giants,11/24/2013,Walt Anderson,22,166,11,85,11,81,23,12,2013
Denver,New England,11/24/2013,Gene Steratore,14,121,9,85,5,36,14,12,2013
San Francisco,Washington,11/25/2013,John Parry,8,55,4,25,4,30,8,12,2013
Green Bay,Detroit,11/28/2013,Gene Steratore,8,75,3,25,5,50,10,13,2013
Oakland,Dallas,11/28/2013,Scott Green,16,111,10,71,6,40,16,13,2013
Pittsburgh,Baltimore,11/28/2013,Clete Blakeman,13,106,4,51,9,55,13,13,2013
Tampa Bay,Carolina,12/01/2013,Ron Winter,7,55,4,30,3,25,8,13,2013
Jacksonville,Cleveland,12/01/2013,Bill Leavy,14,85,5,35,9,50,14,13,2013
Tennessee,Indianapolis,12/01/2013,Walt Coleman,13,124,6,74,7,50,15,13,2013
Denver,Kansas City,12/01/2013,Terry McAulay,19,177,10,75,9,102,20,13,2013
Chicago,Minnesota,12/01/2013,Carl Cheffers,12,111,6,51,6,60,13,13,2013
Miami,N.Y. Jets,12/01/2013,Mike Carey,7,53,3,28,4,25,7,13,2013
Arizona,Philadelphia,12/01/2013,Tony Corrente,11,103,6,55,5,48,13,13,2013
Atlanta,Buffalo,12/01/2013,Walt Anderson,14,124,8,75,6,49,15,13,2013
St. Louis,San Francisco,12/01/2013,Bill Vinovich,20,190,11,105,9,85,20,13,2013
New England,Houston,12/01/2013,Pete Morelli,2,25,0,0,2,25,2,13,2013
Cincinnati,San Diego,12/01/2013,John Parry,8,75,3,30,5,45,9,13,2013
N.Y. Giants,Washington,12/01/2013,Jeff Triplette,9,56,1,1,8,55,11,13,2013
New Orleans,Seattle,12/02/2013,Ed Hochuli,15,118,7,52,8,66,16,13,2013
Houston,Jacksonville,12/05/2013,Tony Corrente,22,234,14,177,8,57,23,14,2013
Minnesota,Baltimore,12/08/2013,Pete Morelli,11,135,6,90,5,45,12,14,2013
Indianapolis,Cincinnati,12/08/2013,Jeff Triplette,13,107,6,47,7,60,13,14,2013
Cleveland,New England,12/08/2013,Jerome Boger,13,116,7,75,6,41,15,14,2013
Oakland,N.Y. Jets,12/08/2013,Gene Steratore,8,67,4,31,4,36,10,14,2013
Carolina,New Orleans,12/08/2013,Walt Anderson,10,80,5,35,5,45,13,14,2013
Detroit,Philadelphia,12/08/2013,Ed Hochuli,10,53,9,48,1,5,10,14,2013
Miami,Pittsburgh,12/08/2013,John Parry,9,65,4,31,5,34,9,14,2013
Buffalo,Tampa Bay,12/08/2013,Bill Vinovich,19,190,11,114,8,76,21,14,2013
Kansas City,Washington,12/08/2013,Carl Cheffers,7,57,3,30,4,27,9,14,2013
Tennessee,Denver,12/08/2013,Scott Green,15,126,8,66,7,60,17,14,2013
St. Louis,Arizona,12/08/2013,Walt Coleman,17,121,11,90,6,31,19,14,2013
N.Y. Giants,San Diego,12/08/2013,Ron Winter,13,102,7,72,6,30,15,14,2013
Seattle,San Francisco,12/08/2013,Clete Blakeman,16,155,9,85,7,70,19,14,2013
Atlanta,Green Bay,12/08/2013,Bill Leavy,5,25,3,15,2,10,6,14,2013
Dallas,Chicago,12/09/2013,Terry McAulay,6,65,4,50,2,15,7,14,2013
San Diego,Denver,12/12/2013,Bill Vinovich,10,78,4,35,6,43,10,15,2013
Washington,Atlanta,12/15/2013,Gene Steratore,16,139,9,66,7,73,21,15,2013
Chicago,Cleveland,12/15/2013,Jeff Triplette,16,130,7,40,9,90,17,15,2013
Houston,Indianapolis,12/15/2013,Jerome Boger,18,150,14,114,4,36,20,15,2013
Buffalo,Jacksonville,12/15/2013,Ron Winter,13,147,7,67,6,80,15,15,2013
New England,Miami,12/15/2013,Tony Corrente,5,23,1,2,4,21,7,15,2013
Philadelphia,Minnesota,12/15/2013,Walt Anderson,12,119,9,94,3,25,12,15,2013
Seattle,N.Y. Giants,12/15/2013,Bill Leavy,13,88,8,50,5,38,15,15,2013
New Orleans,St. Louis,12/15/2013,Mike Carey,12,107,8,77,4,30,13,15,2013
San Francisco,Tampa Bay,12/15/2013,Scott Green,12,94,8,62,4,32,14,15,2013
Arizona,Tennessee,12/15/2013,Pete Morelli,12,85,9,69,3,16,12,15,2013
N.Y. Jets,Carolina,12/15/2013,Terry McAulay,9,79,3,20,6,59,11,15,2013
Kansas City,Oakland,12/15/2013,Clete Blakeman,18,181,8,91,10,90,20,15,2013
Green Bay,Dallas,12/15/2013,Walt Coleman,14,138,7,59,7,79,15,15,2013
Cincinnati,Pittsburgh,12/15/2013,Ed Hochuli,10,75,6,50,4,25,10,15,2013
Baltimore,Detroit,12/16/2013,Carl Cheffers,15,149,7,60,8,89,17,15,2013
Miami,Buffalo,12/22/2013,Clete Blakeman,10,68,6,37,4,31,12,16,2013
New Orleans,Carolina,12/22/2013,Gene Steratore,7,66,4,40,3,26,9,16,2013
Minnesota,Cincinnati,12/22/2013,Terry McAulay,11,95,5,40,6,55,13,16,2013
Denver,Houston,12/22/2013,Ed Hochuli,12,124,8,67,4,57,15,16,2013
Tennessee,Jacksonville,12/22/2013,Bill Vinovich,5,19,1,4,4,15,5,16,2013
Indianapolis,Kansas City,12/22/2013,Tony Corrente,10,96,3,31,7,65,12,16,2013
Cleveland,N.Y. Jets,12/22/2013,Pete Morelli,9,59,3,24,6,35,9,16,2013
Chicago,Philadelphia,12/22/2013,Mike Carey,4,25,2,10,2,15,4,16,2013
Tampa Bay,St. Louis,12/22/2013,John Parry,10,111,3,26,7,85,12,16,2013
Dallas,Washington,12/22/2013,Bill Leavy,14,86,6,42,8,44,17,16,2013
N.Y. Giants,Detroit,12/22/2013,Jerome Boger,12,90,5,30,7,60,13,16,2013
Arizona,Seattle,12/22/2013,Scott Green,16,148,7,46,9,102,17,16,2013
Pittsburgh,Green Bay,12/22/2013,Carl Cheffers,16,148,7,58,9,90,20,16,2013
Oakland,San Diego,12/22/2013,Walt Anderson,15,97,12,73,3,24,19,16,2013
New England,Baltimore,12/22/2013,Ron Winter,16,141,7,58,9,83,19,16,2013
Atlanta,San Francisco,12/23/2013,Walt Coleman,12,82,5,37,7,45,14,16,2013
Carolina,Atlanta,12/29/2013,John Parry,9,94,4,38,5,56,9,17,2013
Green Bay,Chicago,12/29/2013,Clete Blakeman,6,55,1,15,5,40,6,17,2013
Baltimore,Cincinnati,12/29/2013,Scott Green,16,132,6,56,10,76,17,17,2013
Philadelphia,Dallas,12/29/2013,Gene Steratore,7,55,6,50,1,5,7,17,2013
Jacksonville,Indianapolis,12/29/2013,Pete Morelli,7,60,5,50,2,10,7,17,2013
N.Y. Jets,Miami,12/29/2013,Jerome Boger,10,74,5,36,5,38,11,17,2013
Detroit,Minnesota,12/29/2013,Tony Corrente,10,77,6,52,4,25,12,17,2013
Buffalo,New England,12/29/2013,Ed Hochuli,10,85,6,54,4,31,11,17,2013
Tampa Bay,New Orleans,12/29/2013,Carl Cheffers,17,172,8,78,9,94,17,17,2013
Washington,N.Y. Giants,12/29/2013,Bill Vinovich,6,50,3,30,3,20,6,17,2013
Cleveland,Pittsburgh,12/29/2013,Mike Carey,5,45,3,30,2,15,6,17,2013
Houston,Tennessee,12/29/2013,Terry McAulay,12,131,5,55,7,76,13,17,2013
San Francisco,Arizona,12/29/2013,Walt Anderson,7,50,4,20,3,30,7,17,2013
Denver,Oakland,12/29/2013,Ron Winter,8,66,6,56,2,10,8,17,2013
Kansas City,San Diego,12/29/2013,Bill Leavy,5,27,1,5,4,22,6,17,2013
St. Louis,Seattle,12/29/2013,Jeff Triplette,19,152,12,87,7,65,21,17,2013
Green Bay,Seattle,09/04/2014,John Parry,12,134,8,65,4,69,12,1,2014
New Orleans,Atlanta,09/07/2014,Bill Leavy,13,123,3,27,10,96,14,1,2014
Cincinnati,Baltimore,09/07/2014,Gene Steratore,7,74,4,45,3,29,8,1,2014
Buffalo,Chicago,09/07/2014,Brad Allen,13,151,9,108,4,43,19,1,2014
Washington,Houston,09/07/2014,Jerome Boger,13,115,7,70,6,45,18,1,2014
Tennessee,Kansas City,09/07/2014,Ron Torbert,15,135,12,110,3,25,20,1,2014
New England,Miami,09/07/2014,Walt Anderson,13,126,9,100,4,26,16,1,2014
Oakland,N.Y. Jets,09/07/2014,Craig Wrolstad,15,125,4,20,11,105,17,1,2014
Jacksonville,Philadelphia,09/07/2014,Jeff Triplette,13,105,7,55,6,50,15,1,2014
Cleveland,Pittsburgh,09/07/2014,Carl Cheffers,19,151,8,55,11,96,24,1,2014
Minnesota,St. Louis,09/07/2014,Ed Hochuli,20,181,7,60,13,121,25,1,2014
San Francisco,Dallas,09/07/2014,Terry McAulay,21,152,11,80,10,72,21,1,2014
Carolina,Tampa Bay,09/07/2014,Pete Morelli,9,70,6,55,3,15,11,1,2014
Indianapolis,Denver,09/07/2014,Tony Corrente,16,115,9,45,7,70,21,1,2014
N.Y. Giants,Detroit,09/08/2014,Clete Blakeman,12,110,4,25,8,85,12,1,2014
San Diego,Arizona,09/08/2014,Bill Vinovich,11,70,6,47,5,23,13,1,2014
Pittsburgh,Baltimore,09/11/2014,Ed Hochuli,13,110,9,75,4,35,15,2,2014
Miami,Buffalo,09/14/2014,Clete Blakeman,9,60,3,20,6,40,10,2,2014
Detroit,Carolina,09/14/2014,Jerome Boger,9,78,5,33,4,45,13,2,2014
Atlanta,Cincinnati,09/14/2014,Bill Vinovich,14,111,7,56,7,55,17,2,2014
New Orleans,Cleveland,09/14/2014,Craig Wrolstad,9,69,5,39,4,30,11,2,2014
New England,Minnesota,09/14/2014,Tony Corrente,22,221,15,163,7,58,26,2,2014
Arizona,N.Y. Giants,09/14/2014,John Parry,16,141,7,71,9,70,20,2,2014
Dallas,Tennessee,09/14/2014,Walt Coleman,9,60,4,25,5,35,9,2,2014
Jacksonville,Washington,09/14/2014,Ron Torbert,17,142,6,44,11,98,24,2,2014
Seattle,San Diego,09/14/2014,Pete Morelli,14,106,8,53,6,53,17,2,2014
St. Louis,Tampa Bay,09/14/2014,Jeff Triplette,9,95,5,65,4,30,13,2,2014
Kansas City,Denver,09/14/2014,Gene Steratore,18,133,7,62,11,71,22,2,2014
N.Y. Jets,Green Bay,09/14/2014,Walt Anderson,10,117,7,82,3,35,14,2,2014
Houston,Oakland,09/14/2014,Brad Allen,12,109,7,85,5,24,21,2,2014
Chicago,San Francisco,09/14/2014,Carl Cheffers,26,176,10,58,16,118,33,2,2014
Philadelphia,Indianapolis,09/15/2014,Terry McAulay,15,160,11,90,4,70,18,2,2014
Tampa Bay,Atlanta,09/18/2014,Craig Wrolstad,16,160,11,110,5,50,23,3,2014
San Diego,Buffalo,09/21/2014,John Parry,17,145,6,44,11,101,19,3,2014
Tennessee,Cincinnati,09/21/2014,Brad Allen,18,149,11,99,7,50,20,3,2014
Baltimore,Cleveland,09/21/2014,Bill Leavy,17,126,5,32,12,94,18,3,2014
Green Bay,Detroit,09/21/2014,Carl Cheffers,11,70,5,30,6,40,11,3,2014
Indianapolis,Jacksonville,09/21/2014,Walt Coleman,10,61,8,46,2,15,16,3,2014
Oakland,New England,09/21/2014,Pete Morelli,12,108,6,49,6,59,17,3,2014
Minnesota,New Orleans,09/21/2014,Walt Anderson,9,74,5,44,4,30,10,3,2014
Houston,N.Y. Giants,09/21/2014,Terry McAulay,9,71,5,40,4,31,10,3,2014
Washington,Philadelphia,09/21/2014,Tony Corrente,19,201,10,131,9,70,24,3,2014
Dallas,St. Louis,09/21/2014,Clete Blakeman,11,134,3,15,8,119,13,3,2014
San Francisco,Arizona,09/21/2014,Gene Steratore,14,143,9,107,5,36,21,3,2014
Kansas City,Miami,09/21/2014,Jeff Triplette,10,88,4,23,6,65,11,3,2014
Denver,Seattle,09/21/2014,Bill Vinovich,11,61,4,27,7,34,13,3,2014
Pittsburgh,Carolina,09/21/2014,Ron Torbert,18,196,11,91,7,105,25,3,2014
Chicago,N.Y. Jets,09/22/2014,Jerome Boger,15,173,9,95,6,78,15,3,2014
N.Y. Giants,Washington,09/25/2014,Carl Cheffers,18,154,7,66,11,88,19,4,2014
Carolina,Baltimore,09/28/2014,Craig Wrolstad,11,99,7,59,4,40,12,4,2014
Green Bay,Chicago,09/28/2014,Terry McAulay,15,116,9,70,6,46,15,4,2014
Buffalo,Houston,09/28/2014,Bill Vinovich,16,130,8,40,8,90,17,4,2014
Tennessee,Indianapolis,09/28/2014,Jerome Boger,17,156,6,68,11,88,21,4,2014
Atlanta,Minnesota,09/28/2014,Ron Torbert,11,90,5,50,6,40,14,4,2014
Detroit,N.Y. Jets,09/28/2014,Walt Coleman,11,65,5,33,6,32,11,4,2014
Miami,Oakland,09/28/2014,Bill Leavy,14,115,5,35,9,80,14,4,2014
Tampa Bay,Pittsburgh,09/28/2014,Walt Anderson,22,175,9,50,13,125,31,4,2014
Jacksonville,San Diego,09/28/2014,Clete Blakeman,10,89,3,32,7,57,12,4,2014
Philadelphia,San Francisco,09/28/2014,Ed Hochuli,20,150,10,70,10,80,21,4,2014
New Orleans,Dallas,09/28/2014,Gene Steratore,9,70,3,20,6,50,10,4,2014
New England,Kansas City,09/29/2014,John Parry,7,65,3,30,4,35,7,4,2014
Minnesota,Green Bay,10/02/2014,Brad Allen,14,121,9,91,5,30,14,5,2014
Chicago,Carolina,10/05/2014,Tony Corrente,13,110,10,80,3,30,14,5,2014
Houston,Dallas,10/05/2014,Pete Morelli,12,91,5,35,7,56,13,5,2014
Buffalo,Detroit,10/05/2014,Craig Wrolstad,19,136,11,74,8,62,24,5,2014
Baltimore,Indianapolis,10/05/2014,Walt Anderson,11,119,5,36,6,83,16,5,2014
Pittsburgh,Jacksonville,10/05/2014,Terry McAulay,11,84,7,50,4,34,15,5,2014
Tampa Bay,New Orleans,10/05/2014,Carl Cheffers,21,163,15,113,6,50,26,5,2014
Atlanta,N.Y. Giants,10/05/2014,Ed Hochuli,11,96,8,81,3,15,15,5,2014
St. Louis,Philadelphia,10/05/2014,Bill Vinovich,14,121,10,82,4,39,17,5,2014
Cleveland,Tennessee,10/05/2014,Gene Steratore,14,142,7,74,7,68,26,5,2014
Arizona,Denver,10/05/2014,Bill Leavy,10,82,3,15,7,67,11,5,2014
N.Y. Jets,San Diego,10/05/2014,Ron Torbert,17,170,12,94,5,76,21,5,2014
Kansas City,San Francisco,10/05/2014,Walt Coleman,6,39,4,29,2,10,8,5,2014
Cincinnati,New England,10/05/2014,Jerome Boger,16,151,4,37,12,114,17,5,2014
Seattle,Washington,10/06/2014,Jeff Triplette,16,120,13,90,3,30,16,5,2014
Indianapolis,Houston,10/09/2014,Ron Torbert,10,117,5,51,5,66,11,6,2014
Chicago,Atlanta,10/12/2014,Walt Anderson,13,99,7,47,6,52,18,6,2014
New England,Buffalo,10/12/2014,Walt Coleman,17,167,9,60,8,107,23,6,2014
Carolina,Cincinnati,10/12/2014,Carl Cheffers,21,179,8,60,13,119,23,6,2014
Pittsburgh,Cleveland,10/12/2014,Pete Morelli,12,102,6,42,6,60,13,6,2014
Green Bay,Miami,10/12/2014,Bill Vinovich,9,69,4,44,5,25,10,6,2014
Detroit,Minnesota,10/12/2014,John Parry,14,100,5,40,9,60,17,6,2014
Denver,N.Y. Jets,10/12/2014,Brad Allen,13,110,11,101,2,9,16,6,2014
Baltimore,Tampa Bay,10/12/2014,Jerome Boger,13,113,8,70,5,43,14,6,2014
Jacksonville,Tennessee,10/12/2014,Jeff Triplette,11,83,6,35,5,48,13,6,2014
San Diego,Oakland,10/12/2014,Tony Corrente,18,139,7,60,11,79,19,6,2014
Washington,Arizona,10/12/2014,Ed Hochuli,20,170,6,62,14,108,21,6,2014
Dallas,Seattle,10/12/2014,Bill Leavy,15,104,6,46,9,58,17,6,2014
N.Y. Giants,Philadelphia,10/12/2014,Clete Blakeman,13,99,10,74,3,25,14,6,2014
San Francisco,St. Louis,10/13/2014,Craig Wrolstad,13,61,5,23,8,38,16,6,2014
N.Y. Jets,New England,10/16/2014,Bill Leavy,16,134,7,70,9,64,17,7,2014
Atlanta,Baltimore,10/19/2014,Carl Cheffers,16,148,7,76,9,72,17,7,2014
Minnesota,Buffalo,10/19/2014,Ed Hochuli,15,98,7,50,8,48,18,7,2014
Miami,Chicago,10/19/2014,Pete Morelli,9,99,7,84,2,15,14,7,2014
New Orleans,Detroit,10/19/2014,Terry McAulay,21,205,12,134,9,71,25,7,2014
Carolina,Green Bay,10/19/2014,Jeff Triplette,14,99,9,70,5,29,20,7,2014
Cincinnati,Indianapolis,10/19/2014,Gene Steratore,12,77,4,20,8,57,13,7,2014
Cleveland,Jacksonville,10/19/2014,Tony Corrente,11,75,8,50,3,25,13,7,2014
Seattle,St. Louis,10/19/2014,Brad Allen,12,109,10,89,2,20,12,7,2014
Tennessee,Washington,10/19/2014,Walt Anderson,18,146,11,96,7,50,22,7,2014
Kansas City,San Diego,10/19/2014,Bill Vinovich,11,122,7,73,4,49,11,7,2014
N.Y. Giants,Dallas,10/19/2014,Jerome Boger,12,86,6,40,6,46,14,7,2014
Arizona,Oakland,10/19/2014,Clete Blakeman,14,117,6,43,8,74,15,7,2014
San Francisco,Denver,10/19/2014,John Parry,14,137,6,62,8,75,17,7,2014
Houston,Pittsburgh,10/20/2014,Walt Coleman,10,58,4,20,6,38,11,7,2014
San Diego,Denver,10/23/2014,Terry McAulay,16,148,7,77,9,71,17,8,2014
Detroit,Atlanta,10/26/2014,Pete Morelli,13,124,8,85,5,39,17,8,2014
Seattle,Carolina,10/26/2014,Walt Coleman,11,61,7,41,4,20,11,8,2014
Baltimore,Cincinnati,10/26/2014,Clete Blakeman,13,91,7,51,6,40,14,8,2014
Miami,Jacksonville,10/26/2014,Jerome Boger,13,89,7,52,6,37,19,8,2014
St. Louis,Kansas City,10/26/2014,Jeff Triplette,15,119,8,68,7,51,16,8,2014
Chicago,New England,10/26/2014,Brad Allen,12,79,5,41,7,38,13,8,2014
Buffalo,N.Y. Jets,10/26/2014,Gene Steratore,17,139,7,49,10,90,19,8,2014
Minnesota,Tampa Bay,10/26/2014,Craig Wrolstad,14,111,6,59,8,52,20,8,2014
Houston,Tennessee,10/26/2014,Bill Leavy,10,96,4,35,6,61,11,8,2014
Philadelphia,Arizona,10/26/2014,Walt Anderson,21,198,11,103,10,95,24,8,2014
Oakland,Cleveland,10/26/2014,Ron Torbert,14,84,8,54,6,30,18,8,2014
Indianapolis,Pittsburgh,10/26/2014,John Parry,15,102,5,43,10,59,23,8,2014
Green Bay,New Orleans,10/26/2014,Ed Hochuli,12,119,8,84,4,35,14,8,2014
Washington,Dallas,10/27/2014,Tony Corrente,9,80,6,45,3,35,11,8,2014
New Orleans,Carolina,10/30/2014,Clete Blakeman,10,103,4,36,6,67,10,9,2014
Jacksonville,Cincinnati,11/02/2014,Ron Torbert,9,75,3,35,6,40,10,9,2014
Tampa Bay,Cleveland,11/02/2014,Terry McAulay,11,77,4,33,7,44,15,9,2014
Arizona,Dallas,11/02/2014,Craig Wrolstad,11,95,6,62,5,33,13,9,2014
Philadelphia,Houston,11/02/2014,John Parry,16,109,7,55,9,54,18,9,2014
N.Y. Jets,Kansas City,11/02/2014,Tony Corrente,8,60,5,40,3,20,9,9,2014
San Diego,Miami,11/02/2014,Brad Allen,10,82,7,57,3,25,11,9,2014
Washington,Minnesota,11/02/2014,Gene Steratore,15,115,6,55,9,60,18,9,2014
St. Louis,San Francisco,11/02/2014,Jerome Boger,18,127,9,83,9,44,22,9,2014
Denver,New England,11/02/2014,Walt Anderson,19,143,10,72,9,71,20,9,2014
Oakland,Seattle,11/02/2014,Ed Hochuli,14,134,5,69,9,65,14,9,2014
Baltimore,Pittsburgh,11/02/2014,Bill Vinovich,17,175,10,108,7,67,19,9,2014
Indianapolis,N.Y. Giants,11/03/2014,Carl Cheffers,8,60,4,30,4,30,11,9,2014
Cleveland,Cincinnati,11/06/2014,Jeff Triplette,13,117,6,62,7,55,16,10,2014
Tennessee,Baltimore,11/09/2014,Walt Coleman,14,107,9,67,5,40,17,10,2014
Kansas City,Buffalo,11/09/2014,Brad Allen,9,63,3,19,6,44,10,10,2014
Miami,Detroit,11/09/2014,Bill Leavy,15,142,5,44,10,98,20,10,2014
Dallas,Jacksonville,11/09/2014,John Parry,11,84,9,65,2,19,14,10,2014
San Francisco,New Orleans,11/09/2014,Bill Vinovich,8,58,2,15,6,43,9,10,2014
Pittsburgh,N.Y. Jets,11/09/2014,Terry McAulay,12,95,3,20,9,75,13,10,2014
Atlanta,Tampa Bay,11/09/2014,Clete Blakeman,15,109,5,30,10,79,18,10,2014
Denver,Oakland,11/09/2014,Carl Cheffers,16,132,12,95,4,37,18,10,2014
St. Louis,Arizona,11/09/2014,Ron Torbert,13,115,8,80,5,35,15,10,2014
N.Y. Giants,Seattle,11/09/2014,Pete Morelli,10,85,4,35,6,50,12,10,2014
Chicago,Green Bay,11/09/2014,Craig Wrolstad,16,213,11,163,5,50,17,10,2014
Carolina,Philadelphia,11/10/2014,Gene Steratore,9,80,4,30,5,50,9,10,2014
Buffalo,Miami,11/13/2014,Walt Coleman,11,100,7,70,4,30,15,11,2014
Atlanta,Carolina,11/16/2014,Walt Anderson,6,73,5,58,1,15,6,11,2014
Minnesota,Chicago,11/16/2014,Ron Torbert,9,78,2,18,7,60,11,11,2014
Houston,Cleveland,11/16/2014,Ed Hochuli,13,122,5,55,8,67,18,11,2014
Philadelphia,Green Bay,11/16/2014,Carl Cheffers,10,105,6,53,4,52,14,11,2014
Seattle,Kansas City,11/16/2014,Bill Leavy,11,56,8,50,3,6,15,11,2014
Cincinnati,New Orleans,11/16/2014,Craig Wrolstad,9,67,4,33,5,34,11,11,2014
San Francisco,N.Y. Giants,11/16/2014,Gene Steratore,7,89,4,35,3,54,11,11,2014
Denver,St. Louis,11/16/2014,Tony Corrente,11,87,8,62,3,25,12,11,2014
Tampa Bay,Washington,11/16/2014,Bill Vinovich,20,168,11,101,9,67,22,11,2014
Oakland,San Diego,11/16/2014,Jeff Triplette,14,81,8,41,6,40,21,11,2014
Detroit,Arizona,11/16/2014,Jerome Boger,13,115,9,80,4,35,16,11,2014
New England,Indianapolis,11/16/2014,Pete Morelli,9,82,5,53,4,29,14,11,2014
Pittsburgh,Tennessee,11/17/2014,Brad Allen,5,49,4,39,1,10,5,11,2014
Kansas City,Oakland,11/20/2014,John Parry,14,119,7,59,7,60,17,12,2014
Cleveland,Atlanta,11/23/2014,Brad Allen,12,70,5,30,7,40,12,12,2014
N.Y. Jets,Buffalo,11/24/2014,Pete Morelli,13,84,9,60,4,24,15,12,2014
Tampa Bay,Chicago,11/23/2014,Walt Coleman,15,132,9,87,6,45,20,12,2014
Cincinnati,Houston,11/23/2014,Terry McAulay,9,75,6,60,3,15,12,12,2014
Jacksonville,Indianapolis,11/23/2014,Ed Hochuli,12,97,6,43,6,54,18,12,2014
Green Bay,Minnesota,11/23/2014,Clete Blakeman,15,152,8,75,7,77,18,12,2014
Detroit,New England,11/23/2014,Tony Corrente,20,138,9,54,11,84,24,12,2014
Tennessee,Philadelphia,11/23/2014,Jerome Boger,16,125,7,56,9,69,20,12,2014
St. Louis,San Diego,11/23/2014,Carl Cheffers,17,175,9,90,8,85,21,12,2014
Arizona,Seattle,11/23/2014,Gene Steratore,10,99,3,25,7,74,11,12,2014
Miami,Denver,11/23/2014,Jeff Triplette,15,148,6,50,9,98,17,12,2014
Washington,San Francisco,11/23/2014,Walt Anderson,12,100,7,53,5,47,13,12,2014
Dallas,N.Y. Giants,11/23/2014,Bill Vinovich,12,93,7,63,5,30,14,12,2014
Baltimore,New Orleans,11/24/2014,Bill Leavy,11,92,6,42,5,50,14,12,2014
Chicago,Detroit,11/27/2014,Bill Vinovich,10,79,5,41,5,38,12,13,2014
Philadelphia,Dallas,11/27/2014,Clete Blakeman,10,62,4,20,6,42,10,13,2014
Seattle,San Francisco,11/27/2014,Tony Corrente,17,125,14,105,3,20,21,13,2014
San Diego,Baltimore,11/30/2014,Walt Anderson,22,189,8,91,14,98,27,13,2014
Cleveland,Buffalo,11/30/2014,Jerome Boger,16,121,10,76,6,45,21,13,2014
Tennessee,Houston,11/30/2014,Jeff Triplette,11,106,6,66,5,40,17,13,2014
Washington,Indianapolis,11/30/2014,John Parry,20,172,10,78,10,94,24,13,2014
N.Y. Giants,Jacksonville,11/30/2014,Craig Wrolstad,13,89,6,40,7,49,14,13,2014
Carolina,Minnesota,11/30/2014,Brad Allen,9,60,4,35,5,25,10,13,2014
New Orleans,Pittsburgh,11/30/2014,Pete Morelli,16,105,11,77,5,28,17,13,2014
Oakland,St. Louis,11/30/2014,Gene Steratore,16,133,8,73,8,60,17,13,2014
Cincinnati,Tampa Bay,11/30/2014,Bill Leavy,23,167,10,73,13,94,26,13,2014
Arizona,Atlanta,11/30/2014,Terry McAulay,14,110,5,34,9,76,19,13,2014
New England,Green Bay,11/30/2014,Ed Hochuli,8,47,4,25,4,22,9,13,2014
Denver,Kansas City,11/30/2014,Walt Coleman,10,67,5,32,5,35,11,13,2014
Miami,N.Y. Jets,12/01/2014,Ron Torbert,10,77,3,20,7,57,12,13,2014
Dallas,Chicago,12/04/2014,Ed Hochuli,17,151,8,97,9,54,18,14,2014
Pittsburgh,Cincinnati,12/07/2014,Tony Corrente,10,74,3,20,7,54,11,14,2014
Indianapolis,Cleveland,12/07/2014,Clete Blakeman,13,125,6,40,7,85,16,14,2014
Tampa Bay,Detroit,12/07/2014,Jeff Triplette,14,172,5,50,9,122,15,14,2014
Houston,Jacksonville,12/07/2014,Carl Cheffers,13,104,7,64,6,40,16,14,2014
Baltimore,Miami,12/07/2014,John Parry,13,66,7,36,6,30,15,14,2014
N.Y. Jets,Minnesota,12/07/2014,Jerome Boger,10,110,4,40,6,70,15,14,2014
Carolina,New Orleans,12/07/2014,Walt Coleman,10,85,6,55,4,30,14,14,2014
N.Y. Giants,Tennessee,12/07/2014,Walt Anderson,12,109,7,70,5,39,15,14,2014
St. Louis,Washington,12/07/2014,Brad Allen,16,149,11,98,5,51,17,14,2014
Kansas City,Arizona,12/07/2014,Craig Wrolstad,15,115,9,75,6,40,19,14,2014
Buffalo,Denver,12/07/2014,Ron Torbert,16,143,11,98,5,45,21,14,2014
San Francisco,Oakland,12/07/2014,Terry McAulay,17,134,7,50,10,84,17,14,2014
Seattle,Philadelphia,12/07/2014,Bill Vinovich,12,136,8,67,4,69,13,14,2014
New England,San Diego,12/07/2014,Bill Leavy,14,131,6,70,8,61,14,14,2014
Atlanta,Green Bay,12/08/2014,Pete Morelli,8,51,3,11,5,40,10,14,2014
Arizona,St. Louis,12/11/2014,Walt Coleman,14,128,8,59,6,69,15,15,2014
Pittsburgh,Atlanta,12/14/2014,Clete Blakeman,6,59,3,34,3,25,8,15,2014
Jacksonville,Baltimore,12/14/2014,Tony Corrente,14,130,5,60,9,70,17,15,2014
Green Bay,Buffalo,12/14/2014,Bill Leavy,19,145,9,70,10,75,21,15,2014
Tampa Bay,Carolina,12/14/2014,Ron Torbert,8,54,4,29,4,25,9,15,2014
Cincinnati,Cleveland,12/14/2014,Walt Anderson,14,109,5,41,9,68,17,15,2014
Minnesota,Detroit,12/14/2014,Pete Morelli,8,60,3,25,5,35,8,15,2014
Houston,Indianapolis,12/14/2014,Gene Steratore,15,111,8,66,7,45,17,15,2014
Oakland,Kansas City,12/14/2014,Jerome Boger,21,159,10,75,11,84,26,15,2014
Miami,New England,12/14/2014,Bill Vinovich,10,86,5,35,5,51,13,15,2014
Washington,N.Y. Giants,12/14/2014,Jeff Triplette,19,195,10,135,9,60,22,15,2014
Denver,San Diego,12/14/2014,Craig Wrolstad,15,136,7,71,8,65,19,15,2014
N.Y. Jets,Tennessee,12/14/2014,John Parry,16,122,7,46,9,76,18,15,2014
San Francisco,Seattle,12/14/2014,Ed Hochuli,15,128,8,78,7,50,16,15,2014
Dallas,Philadelphia,12/14/2014,Terry McAulay,19,174,11,79,8,95,24,15,2014
New Orleans,Chicago,12/15/2014,Carl Cheffers,12,99,3,25,9,74,19,15,2014
Tennessee,Jacksonville,12/18/2014,Clete Blakeman,10,72,7,47,3,25,12,16,2014
Philadelphia,Washington,12/20/2014,Carl Cheffers,16,117,13,102,3,15,20,16,2014
San Diego,San Francisco,12/20/2014,Jeff Triplette,17,130,8,38,9,92,30,16,2014
Cleveland,Carolina,12/21/2014,Ed Hochuli,11,98,6,49,5,49,11,16,2014
Detroit,Chicago,12/21/2014,Gene Steratore,12,146,7,60,5,86,14,16,2014
Baltimore,Houston,12/21/2014,Walt Coleman,14,125,7,56,7,69,19,16,2014
Minnesota,Miami,12/21/2014,Tony Corrente,15,128,8,74,7,54,23,16,2014
Atlanta,New Orleans,12/21/2014,John Parry,9,89,6,64,3,25,10,16,2014
New England,N.Y. Jets,12/21/2014,Brad Allen,7,52,5,38,2,14,8,16,2014
Kansas City,Pittsburgh,12/21/2014,Ron Torbert,8,79,4,39,4,40,13,16,2014
Green Bay,Tampa Bay,12/21/2014,Terry McAulay,8,70,5,40,3,30,9,16,2014
N.Y. Giants,St. Louis,12/21/2014,Pete Morelli,21,225,12,149,9,76,30,16,2014
Indianapolis,Dallas,12/21/2014,Bill Leavy,15,122,8,55,7,67,19,16,2014
Buffalo,Oakland,12/21/2014,Craig Wrolstad,11,90,7,55,4,35,11,16,2014
Seattle,Arizona,12/21/2014,Walt Anderson,12,102,11,97,1,5,16,16,2014
Denver,Cincinnati,12/22/2014,Bill Vinovich,13,117,6,72,7,45,16,16,2014
Carolina,Atlanta,12/28/2014,Bill Leavy,11,72,5,36,6,36,14,17,2014
Cleveland,Baltimore,12/28/2014,Gene Steratore,15,113,7,58,8,55,19,17,2014
Detroit,Green Bay,12/28/2014,Walt Anderson,15,93,10,53,5,40,16,17,2014
Jacksonville,Houston,12/28/2014,John Parry,10,80,4,25,6,55,15,17,2014
San Diego,Kansas City,12/28/2014,Pete Morelli,17,113,10,67,7,46,18,17,2014
N.Y. Jets,Miami,12/28/2014,Craig Wrolstad,10,80,5,40,5,40,16,17,2014
Chicago,Minnesota,12/28/2014,Jeff Triplette,12,75,8,50,4,25,14,17,2014
Buffalo,New England,12/28/2014,Terry McAulay,10,99,5,44,5,55,12,17,2014
Philadelphia,N.Y. Giants,12/28/2014,Walt Coleman,13,141,5,35,8,106,15,17,2014
Cincinnati,Pittsburgh,12/28/2014,Ed Hochuli,6,55,5,45,1,10,9,17,2014
New Orleans,Tampa Bay,12/28/2014,Brad Allen,6,38,2,15,4,23,8,17,2014
Indianapolis,Tennessee,12/28/2014,Tony Corrente,8,40,4,20,4,20,9,17,2014
Dallas,Washington,12/28/2014,Jerome Boger,16,149,7,48,9,101,16,17,2014
Oakland,Denver,12/28/2014,Clete Blakeman,10,102,9,86,1,16,11,17,2014
Arizona,San Francisco,12/28/2014,Carl Cheffers,13,99,3,21,10,78,17,17,2014
St. Louis,Seattle,12/28/2014,Ron Torbert,8,65,6,45,2,20,11,17,2014
Pittsburgh,New England,09/10/2015,Carl Cheffers,15,141,8,77,7,64,16,1,2015
Green Bay,Chicago,09/13/2015,Craig Wrolstad,16,138,10,74,6,64,20,1,2015
Seattle,St. Louis,09/13/2015,Jeff Triplette,11,76,7,46,4,30,15,1,2015
Carolina,Jacksonville,09/13/2015,Ron Torbert,6,47,3,22,3,25,8,1,2015
Miami,Washington,09/13/2015,Walt Coleman,17,127,6,39,11,88,21,1,2015
Indianapolis,Buffalo,09/13/2015,John Parry,16,162,5,49,11,113,18,1,2015
Cleveland,N.Y. Jets,09/13/2015,Jerome Boger,16,139,12,109,4,30,17,1,2015
Kansas City,Houston,09/13/2015,Pete Morelli,8,64,2,25,6,39,9,1,2015
New Orleans,Arizona,09/13/2015,Walt Anderson,12,103,7,73,5,30,15,1,2015
Detroit,San Diego,09/13/2015,Clete Blakeman,9,69,4,29,5,40,9,1,2015
Baltimore,Denver,09/13/2015,Gene Steratore,11,60,3,15,8,45,11,1,2015
Cincinnati,Oakland,09/13/2015,Brad Allen,11,82,6,50,5,32,15,1,2015
Tennessee,Tampa Bay,09/13/2015,John Hussey,20,152,8,55,12,97,25,1,2015
N.Y. Giants,Dallas,09/13/2015,Bill Vinovich,8,79,5,44,3,35,10,1,2015
Philadelphia,Atlanta,09/14/2015,Terry McAulay,17,145,10,88,7,57,22,1,2015
Minnesota,San Francisco,09/14/2015,Ed Hochuli,13,82,5,25,8,57,16,1,2015
Denver,Kansas City,09/17/2015,Walt Anderson,17,145,8,85,9,60,21,2,2015
Houston,Carolina,09/20/2015,Clete Blakeman,20,162,10,70,10,92,21,2,2015
New England,Buffalo,09/20/2015,Ron Torbert,25,259,11,119,14,140,31,2,2015
San Diego,Cincinnati,09/20/2015,Jeff Triplette,17,139,8,64,9,75,23,2,2015
Tennessee,Cleveland,09/20/2015,Terry McAulay,13,125,9,85,4,40,15,2,2015
Atlanta,N.Y. Giants,09/20/2015,Brad Allen,12,100,6,65,6,35,15,2,2015
St. Louis,Washington,09/20/2015,Ed Hochuli,16,133,9,80,7,53,19,2,2015
Arizona,Chicago,09/20/2015,Jerome Boger,22,228,8,58,14,170,23,2,2015
Detroit,Minnesota,09/20/2015,Bill Vinovich,16,136,6,39,10,97,17,2,2015
Tampa Bay,New Orleans,09/20/2015,Carl Cheffers,21,205,11,90,10,115,24,2,2015
San Francisco,Pittsburgh,09/20/2015,Craig Wrolstad,14,104,7,46,7,58,16,2,2015
Baltimore,Oakland,09/20/2015,Pete Morelli,26,215,10,109,16,106,30,2,2015
Miami,Jacksonville,09/20/2015,John Parry,22,205,13,112,9,93,25,2,2015
Dallas,Philadelphia,09/20/2015,Tony Corrente,26,202,18,142,8,60,31,2,2015
Seattle,Green Bay,09/20/2015,Gene Steratore,12,127,6,92,6,35,22,2,2015
N.Y. Jets,Indianapolis,09/21/2015,John Hussey,19,174,8,90,11,84,23,2,2015
Washington,N.Y. Giants,09/24/2015,Ron Torbert,15,125,7,58,8,67,18,3,2015
Atlanta,Dallas,09/27/2015,Pete Morelli,11,101,6,70,5,31,11,3,2015
New Orleans,Carolina,09/27/2015,Ed Hochuli,18,143,8,55,10,88,19,3,2015
Philadelphia,N.Y. Jets,09/27/2015,Gene Steratore,11,74,5,21,6,53,16,3,2015
Tampa Bay,Houston,09/27/2015,Bill Vinovich,16,142,10,84,6,58,20,3,2015
San Diego,Minnesota,09/27/2015,Terry McAulay,10,113,7,74,3,39,13,3,2015
Pittsburgh,St. Louis,09/27/2015,John Hussey,11,160,4,63,7,97,11,3,2015
Jacksonville,New England,09/27/2015,Walt Coleman,11,144,7,114,4,30,12,3,2015
Cincinnati,Baltimore,09/27/2015,Walt Anderson,22,183,9,67,13,116,27,3,2015
Oakland,Cleveland,09/27/2015,Clete Blakeman,18,135,12,85,6,50,21,3,2015
Indianapolis,Tennessee,09/27/2015,Craig Wrolstad,17,126,11,71,6,55,17,3,2015
San Francisco,Arizona,09/27/2015,Tony Corrente,10,69,6,45,4,24,14,3,2015
Chicago,Seattle,09/27/2015,Carl Cheffers,11,81,6,40,5,41,11,3,2015
Buffalo,Miami,09/27/2015,Jerome Boger,11,76,5,40,6,36,15,3,2015
Denver,Detroit,09/27/2015,Jeff Triplette,18,169,9,94,9,75,19,3,2015
Kansas City,Green Bay,09/28/2015,John Parry,19,127,7,38,12,89,25,3,2015
Baltimore,Pittsburgh,10/01/2015,Clete Blakeman,8,50,4,30,4,20,9,4,2015
N.Y. Jets,Miami,10/04/2015,Craig Wrolstad,23,243,14,163,9,80,25,4,2015
Oakland,Chicago,10/04/2015,Jeff Triplette,12,95,5,47,7,48,14,4,2015
Houston,Atlanta,10/04/2015,Carl Cheffers,15,115,5,35,10,80,18,4,2015
Kansas City,Cincinnati,10/04/2015,Ron Torbert,18,130,7,46,11,84,19,4,2015
Jacksonville,Indianapolis,10/04/2015,Ed Hochuli,17,137,13,92,4,45,22,4,2015
Philadelphia,Washington,10/04/2015,Jerome Boger,18,182,8,72,10,110,23,4,2015
Carolina,Tampa Bay,10/04/2015,Gene Steratore,10,93,5,45,5,48,13,4,2015
N.Y. Giants,Buffalo,10/04/2015,John Hussey,28,220,11,85,17,135,29,4,2015
Cleveland,San Diego,10/04/2015,Bill Vinovich,18,122,12,91,6,31,20,4,2015
Green Bay,San Francisco,10/04/2015,Terry McAulay,12,95,8,65,4,30,13,4,2015
St. Louis,Arizona,10/04/2015,John Parry,10,86,7,66,3,20,12,4,2015
Minnesota,Denver,10/04/2015,Walt Coleman,17,103,9,63,8,40,19,4,2015
Dallas,New Orleans,10/04/2015,Brad Allen,14,94,6,30,8,64,15,4,2015
Detroit,Seattle,10/05/2015,Tony Corrente,9,67,4,37,5,30,10,4,2015
Indianapolis,Houston,10/08/2015,Terry McAulay,20,190,7,65,13,125,22,5,2015
New Orleans,Philadelphia,10/11/2015,Ron Torbert,11,113,7,78,4,35,13,5,2015
Chicago,Kansas City,10/11/2015,Tony Corrente,9,98,6,49,3,49,13,5,2015
Seattle,Cincinnati,10/11/2015,John Parry,17,162,10,112,7,50,17,5,2015
Washington,Atlanta,10/11/2015,Bill Vinovich,9,113,5,51,4,62,12,5,2015
Jacksonville,Tampa Bay,10/11/2015,Jerome Boger,13,84,3,12,10,72,17,5,2015
Cleveland,Baltimore,10/11/2015,Jeff Triplette,21,172,9,74,12,98,23,5,2015
Buffalo,Tennessee,10/11/2015,Walt Anderson,16,136,7,62,9,74,21,5,2015
St. Louis,Green Bay,10/11/2015,Brad Allen,15,107,8,40,7,67,17,5,2015
Arizona,Detroit,10/11/2015,Gene Steratore,18,155,9,70,9,85,21,5,2015
New England,Dallas,10/11/2015,Clete Blakeman,16,115,9,65,7,50,18,5,2015
Denver,Oakland,10/11/2015,John Hussey,12,144,6,103,6,41,13,5,2015
San Francisco,N.Y. Giants,10/11/2015,Walt Coleman,10,93,4,28,6,65,10,5,2015
Pittsburgh,San Diego,10/12/2015,Pete Morelli,15,140,8,86,7,54,18,5,2015
Atlanta,New Orleans,10/15/2015,Gene Steratore,10,56,7,41,3,15,10,6,2015
Chicago,Detroit,10/18/2015,Walt Coleman,19,174,9,76,10,98,20,6,2015
Washington,N.Y. Jets,10/18/2015,Pete Morelli,4,20,3,15,1,5,7,6,2015
Arizona,Pittsburgh,10/18/2015,Ed Hochuli,15,159,9,111,6,48,18,6,2015
Kansas City,Minnesota,10/18/2015,Jerome Boger,13,145,8,95,5,50,18,6,2015
Cincinnati,Buffalo,10/18/2015,Clete Blakeman,11,113,3,20,8,93,11,6,2015
Denver,Cleveland,10/18/2015,Craig Wrolstad,14,111,8,81,6,30,16,6,2015
Miami,Tennessee,10/18/2015,Jeff Triplette,16,147,9,97,7,50,17,6,2015
Houston,Jacksonville,10/18/2015,Brad Allen,17,133,10,69,7,64,20,6,2015
Carolina,Seattle,10/18/2015,Terry McAulay,12,73,5,25,7,48,13,6,2015
San Diego,Green Bay,10/18/2015,Walt Anderson,15,126,9,76,6,50,21,6,2015
Baltimore,San Francisco,10/18/2015,John Parry,7,40,3,15,4,25,9,6,2015
New England,Indianapolis,10/18/2015,Tony Corrente,19,175,8,72,11,103,22,6,2015
N.Y. Giants,Philadelphia,10/19/2015,Carl Cheffers,21,164,12,92,9,72,24,6,2015
Seattle,San Francisco,10/22/2015,Walt Anderson,10,83,6,50,4,33,12,7,2015
Buffalo,Jacksonville,10/25/2015,Terry McAulay,20,153,10,87,10,66,24,7,2015
Cleveland,St. Louis,10/25/2015,Pete Morelli,20,173,11,98,9,75,23,7,2015
Houston,Miami,10/25/2015,John Hussey,11,77,3,25,8,52,19,7,2015
N.Y. Jets,New England,10/25/2015,Bill Vinovich,8,67,4,29,4,38,11,7,2015
Pittsburgh,Kansas City,10/25/2015,Walt Coleman,7,71,1,5,6,66,7,7,2015
Tampa Bay,Washington,10/25/2015,Jeff Triplette,20,162,16,142,4,20,22,7,2015
Minnesota,Detroit,10/25/2015,Ed Hochuli,8,61,3,31,5,30,9,7,2015
New Orleans,Indianapolis,10/25/2015,Carl Cheffers,19,142,12,100,7,42,25,7,2015
Atlanta,Tennessee,10/25/2015,Brad Allen,11,98,6,53,5,45,11,7,2015
Oakland,San Diego,10/25/2015,Jerome Boger,23,222,14,136,9,86,26,7,2015
Dallas,N.Y. Giants,10/25/2015,John Parry,10,59,7,46,3,13,10,7,2015
Philadelphia,Carolina,10/25/2015,Craig Wrolstad,12,89,7,46,5,43,14,7,2015
Baltimore,Arizona,10/26/2015,Ron Torbert,13,104,9,64,4,40,16,7,2015
Miami,New England,10/29/2015,Pete Morelli,15,109,7,40,8,69,16,8,2015
Detroit,Kansas City,11/01/2015,Jeff Triplette,11,101,8,81,3,20,12,8,2015
San Diego,Baltimore,11/01/2015,Gene Steratore,11,112,6,66,5,46,13,8,2015
Cincinnati,Pittsburgh,11/01/2015,Tony Corrente,20,185,10,94,10,91,27,8,2015
Tennessee,Houston,11/01/2015,Clete Blakeman,13,130,6,45,7,85,16,8,2015
Minnesota,Chicago,11/01/2015,John Hussey,8,73,4,35,4,38,8,8,2015
Tampa Bay,Atlanta,11/01/2015,Ron Torbert,19,167,8,43,11,124,23,8,2015
N.Y. Giants,New Orleans,11/01/2015,Craig Wrolstad,18,146,6,53,12,93,21,8,2015
San Francisco,St. Louis,11/01/2015,Jerome Boger,25,186,13,93,12,93,28,8,2015
Arizona,Cleveland,11/01/2015,Walt Coleman,12,60,5,25,7,35,16,8,2015
N.Y. Jets,Oakland,11/01/2015,Ed Hochuli,12,101,6,40,6,61,16,8,2015
Seattle,Dallas,11/01/2015,Carl Cheffers,10,80,5,40,5,40,11,8,2015
Green Bay,Denver,11/01/2015,John Parry,13,108,2,15,11,93,17,8,2015
Indianapolis,Carolina,11/02/2015,Bill Vinovich,8,70,2,15,6,55,8,8,2015
Cleveland,Cincinnati,11/05/2015,Carl Cheffers,6,48,4,28,2,20,8,9,2015
St. Louis,Minnesota,11/08/2015,Ron Torbert,18,154,12,87,6,67,20,9,2015
Green Bay,Carolina,11/08/2015,Gene Steratore,13,132,7,87,6,45,16,9,2015
Washington,New England,11/08/2015,Terry McAulay,10,70,4,27,6,43,11,9,2015
Tennessee,New Orleans,11/08/2015,Jerome Boger,17,141,9,66,8,75,20,9,2015
Miami,Buffalo,11/08/2015,Carl Cheffers,21,156,8,62,13,94,25,9,2015
Jacksonville,N.Y. Jets,11/08/2015,Walt Coleman,10,71,4,30,6,41,12,9,2015
Oakland,Pittsburgh,11/08/2015,Bill Vinovich,8,63,3,21,5,42,11,9,2015
N.Y. Giants,Tampa Bay,11/08/2015,Clete Blakeman,15,128,6,49,9,79,18,9,2015
Atlanta,San Francisco,11/08/2015,Tony Corrente,11,93,6,63,5,30,12,9,2015
Denver,Indianapolis,11/08/2015,Brad Allen,12,86,8,56,4,30,13,9,2015
Philadelphia,Dallas,11/08/2015,Ed Hochuli,18,128,10,70,8,58,20,9,2015
Chicago,San Diego,11/09/2015,Craig Wrolstad,14,109,6,55,8,54,14,9,2015
Buffalo,N.Y. Jets,11/12/2015,Brad Allen,8,64,5,44,3,20,9,10,2015
New Orleans,Washington,11/15/2015,John Parry,12,76,7,50,5,26,13,10,2015
Detroit,Green Bay,11/15/2015,John Hussey,8,90,3,35,5,55,9,10,2015
Dallas,Tampa Bay,11/15/2015,Bill Vinovich,13,130,6,68,7,62,14,10,2015
Carolina,Tennessee,11/15/2015,Walt Anderson,9,75,5,45,4,30,9,10,2015
Chicago,St. Louis,11/15/2015,Jeff Triplette,12,101,4,44,8,57,14,10,2015
Miami,Philadelphia,11/15/2015,Terry McAulay,15,138,8,84,7,54,22,10,2015
Jacksonville,Baltimore,11/15/2015,Pete Morelli,13,151,4,30,9,121,15,10,2015
Cleveland,Pittsburgh,11/15/2015,Ron Torbert,17,238,12,188,5,50,24,10,2015
Minnesota,Oakland,11/15/2015,Tony Corrente,11,97,3,15,8,82,14,10,2015
New England,N.Y. Giants,11/15/2015,Ed Hochuli,15,142,7,93,8,49,18,10,2015
Kansas City,Denver,11/15/2015,Gene Steratore,16,157,11,102,5,55,18,10,2015
Arizona,Seattle,11/15/2015,Clete Blakeman,23,202,9,71,14,131,25,10,2015
Houston,Cincinnati,11/16/2015,Walt Coleman,14,124,5,54,9,70,16,10,2015
Tennessee,Jacksonville,11/19/2015,Craig Wrolstad,14,147,6,59,8,88,14,11,2015
Denver,Chicago,11/22/2015,Pete Morelli,8,118,8,118,0,0,9,11,2015
Oakland,Detroit,11/22/2015,Clete Blakeman,13,86,6,31,7,55,15,11,2015
Indianapolis,Atlanta,11/22/2015,Walt Anderson,13,111,7,42,6,69,16,11,2015
N.Y. Jets,Houston,11/22/2015,John Parry,10,108,7,54,3,54,14,11,2015
Tampa Bay,Philadelphia,11/22/2015,Brad Allen,14,107,9,82,5,25,19,11,2015
Green Bay,Minnesota,11/22/2015,Walt Coleman,12,129,4,19,8,110,16,11,2015
Washington,Carolina,11/22/2015,Jerome Boger,17,134,9,68,8,66,22,11,2015
Dallas,Miami,11/22/2015,Jeff Triplette,19,153,10,79,9,74,22,11,2015
St. Louis,Baltimore,11/22/2015,Tony Corrente,16,172,6,35,10,137,22,11,2015
Cincinnati,Arizona,11/22/2015,Terry McAulay,17,148,10,108,7,40,19,11,2015
San Francisco,Seattle,11/22/2015,Ed Hochuli,13,93,5,42,8,51,16,11,2015
Kansas City,San Diego,11/22/2015,Carl Cheffers,11,74,5,35,6,39,13,11,2015
Buffalo,New England,11/23/2015,Gene Steratore,10,105,5,44,5,61,14,11,2015
Philadelphia,Detroit,11/26/2015,John Parry,6,59,2,30,4,29,9,12,2015
Carolina,Dallas,11/26/2015,Ron Torbert,13,93,8,53,5,40,13,12,2015
Chicago,Green Bay,11/26/2015,Ed Hochuli,15,133,12,95,3,38,17,12,2015
N.Y. Giants,Washington,11/29/2015,Carl Cheffers,11,115,4,35,7,80,18,12,2015
Minnesota,Atlanta,11/29/2015,Clete Blakeman,15,131,9,53,6,78,16,12,2015
St. Louis,Cincinnati,11/29/2015,Craig Wrolstad,10,80,7,45,3,35,14,12,2015
New Orleans,Houston,11/29/2015,John Hussey,16,122,10,82,6,40,16,12,2015
Tampa Bay,Indianapolis,11/29/2015,Walt Coleman,18,140,12,95,6,45,20,12,2015
Miami,N.Y. Jets,11/29/2015,Bill Vinovich,12,85,6,45,6,40,16,12,2015
San Diego,Jacksonville,11/29/2015,Jerome Boger,14,105,8,70,6,35,15,12,2015
Oakland,Tennessee,11/29/2015,Jeff Triplette,15,119,11,94,4,25,20,12,2015
Buffalo,Kansas City,11/29/2015,Terry McAulay,17,149,9,91,8,58,18,12,2015
Arizona,San Francisco,11/29/2015,Pete Morelli,20,128,7,47,13,81,21,12,2015
Pittsburgh,Seattle,11/29/2015,Walt Anderson,14,141,6,65,8,76,16,12,2015
New England,Denver,11/29/2015,Tony Corrente,11,93,5,47,6,46,11,12,2015
Baltimore,Cleveland,11/30/2015,Brad Allen,9,65,7,50,2,15,9,12,2015
Green Bay,Detroit,12/03/2015,Carl Cheffers,16,163,7,55,9,108,17,13,2015
N.Y. Jets,N.Y. Giants,12/06/2015,John Hussey,16,121,8,61,8,60,17,13,2015
Houston,Buffalo,12/06/2015,Tony Corrente,15,131,10,89,5,42,18,13,2015
Baltimore,Miami,12/06/2015,John Parry,10,67,5,36,5,31,12,13,2015
Cincinnati,Cleveland,12/06/2015,Jeff Triplette,12,139,5,55,7,84,13,13,2015
Jacksonville,Tennessee,12/06/2015,Gene Steratore,10,59,6,21,4,38,10,13,2015
San Francisco,Chicago,12/06/2015,Jerome Boger,14,122,6,50,8,72,15,13,2015
Seattle,Minnesota,12/06/2015,Terry McAulay,18,160,9,65,9,95,20,13,2015
Carolina,New Orleans,12/06/2015,Brad Allen,19,191,8,87,11,104,19,13,2015
Atlanta,Tampa Bay,12/06/2015,Ed Hochuli,15,111,7,58,8,53,15,13,2015
Arizona,St. Louis,12/06/2015,Bill Vinovich,10,129,3,25,7,104,11,13,2015
Kansas City,Oakland,12/06/2015,Craig Wrolstad,15,109,11,88,4,21,15,13,2015
Denver,San Diego,12/06/2015,Walt Coleman,11,90,3,18,8,72,13,13,2015
Philadelphia,New England,12/06/2015,Ron Torbert,11,127,8,97,3,30,16,13,2015
Indianapolis,Pittsburgh,12/06/2015,Pete Morelli,9,78,5,30,4,48,10,13,2015
Dallas,Washington,12/07/2015,Walt Anderson,17,144,8,70,9,74,19,13,2015
Minnesota,Arizona,12/10/2015,Gene Steratore,7,55,3,25,4,30,12,14,2015
Buffalo,Philadelphia,12/13/2015,Ed Hochuli,20,156,15,101,5,55,23,14,2015
Tennessee,N.Y. Jets,12/13/2015,Jerome Boger,6,40,3,20,3,20,10,14,2015
Pittsburgh,Cincinnati,12/13/2015,John Parry,9,109,5,82,4,27,12,14,2015
New England,Houston,12/13/2015,Jeff Triplette,10,82,6,46,4,36,11,14,2015
Indianapolis,Jacksonville,12/13/2015,Carl Cheffers,13,125,8,85,5,40,18,14,2015
San Diego,Kansas City,12/13/2015,Pete Morelli,15,101,7,48,8,53,18,14,2015
Washington,Chicago,12/13/2015,Ron Torbert,15,142,8,63,7,79,16,14,2015
Atlanta,Carolina,12/13/2015,Tony Corrente,12,114,6,54,6,60,19,14,2015
New Orleans,Tampa Bay,12/13/2015,Clete Blakeman,20,175,12,95,8,80,20,14,2015
Detroit,St. Louis,12/13/2015,Walt Anderson,10,93,5,45,5,48,15,14,2015
San Francisco,Cleveland,12/13/2015,John Hussey,13,111,5,40,8,71,15,14,2015
Oakland,Denver,12/13/2015,Bill Vinovich,14,97,10,70,4,27,14,14,2015
Dallas,Green Bay,12/13/2015,Brad Allen,14,99,6,30,8,69,16,14,2015
Seattle,Baltimore,12/13/2015,Walt Coleman,15,136,6,42,9,94,18,14,2015
N.Y. Giants,Miami,12/14/2015,Craig Wrolstad,15,148,3,25,12,123,15,14,2015
Tampa Bay,St. Louis,12/17/2015,Jerome Boger,14,91,9,56,5,35,17,15,2015
N.Y. Jets,Dallas,12/19/2015,Craig Wrolstad,14,115,8,61,6,54,16,15,2015
Carolina,N.Y. Giants,12/20/2015,Terry McAulay,14,135,7,88,7,47,18,15,2015
Arizona,Philadelphia,12/20/2015,Tony Corrente,6,48,1,10,5,38,6,15,2015
Chicago,Minnesota,12/20/2015,Brad Allen,10,84,6,39,4,45,16,15,2015
Atlanta,Jacksonville,12/20/2015,Bill Vinovich,10,105,5,43,5,62,20,15,2015
Houston,Indianapolis,12/20/2015,Ed Hochuli,14,142,6,48,8,94,16,15,2015
Tennessee,New England,12/20/2015,Walt Coleman,8,64,3,29,5,35,12,15,2015
Kansas City,Baltimore,12/20/2015,Jeff Triplette,13,118,6,55,7,63,14,15,2015
Buffalo,Washington,12/20/2015,Clete Blakeman,13,62,8,56,5,6,15,15,2015
Cleveland,Seattle,12/20/2015,Gene Steratore,9,70,4,40,5,30,12,15,2015
Green Bay,Oakland,12/20/2015,Walt Anderson,16,170,6,75,10,95,20,15,2015
Denver,Pittsburgh,12/20/2015,Carl Cheffers,21,190,12,127,9,63,29,15,2015
Miami,San Diego,12/20/2015,John Hussey,16,120,9,72,7,48,20,15,2015
Cincinnati,San Francisco,12/20/2015,Ron Torbert,17,143,6,45,11,98,19,15,2015
Detroit,New Orleans,12/21/2015,Pete Morelli,16,120,10,92,6,28,20,15,2015
San Diego,Oakland,12/24/2015,Carl Cheffers,24,196,9,75,15,121,28,16,2015
Washington,Philadelphia,12/26/2015,Walt Coleman,16,115,8,70,8,45,21,16,2015
Jacksonville,New Orleans,12/27/2015,Ron Torbert,13,95,8,55,5,40,13,16,2015
Indianapolis,Miami,12/27/2015,Gene Steratore,15,110,6,60,9,50,15,16,2015
New England,N.Y. Jets,12/27/2015,Clete Blakeman,7,46,1,7,6,39,8,16,2015
Houston,Tennessee,12/27/2015,Brad Allen,8,71,4,28,4,43,11,16,2015
Cleveland,Kansas City,12/27/2015,Walt Anderson,13,116,8,83,5,33,14,16,2015
San Francisco,Detroit,12/27/2015,Bill Vinovich,18,136,11,65,7,71,21,16,2015
N.Y. Giants,Minnesota,12/27/2015,Tony Corrente,9,58,7,48,2,10,11,16,2015
Carolina,Atlanta,12/27/2015,John Parry,7,60,4,40,3,20,13,16,2015
Chicago,Tampa Bay,12/27/2015,Pete Morelli,7,72,3,25,4,47,8,16,2015
Dallas,Buffalo,12/27/2015,Jeff Triplette,15,127,8,65,7,62,18,16,2015
Green Bay,Arizona,12/27/2015,Terry McAulay,17,178,7,59,10,119,20,16,2015
St. Louis,Seattle,12/27/2015,John Hussey,15,143,5,60,10,83,16,16,2015
Pittsburgh,Baltimore,12/27/2015,Craig Wrolstad,15,146,3,25,12,121,15,16,2015
Cincinnati,Denver,12/28/2015,Ed Hochuli,11,85,6,45,5,40,11,16,2015
N.Y. Jets,Buffalo,01/03/2016,Walt Anderson,10,86,6,41,4,45,10,17,2015
New England,Miami,01/03/2016,Ed Hochuli,17,134,7,41,10,93,20,17,2015
Baltimore,Cincinnati,01/03/2016,Carl Cheffers,15,110,4,38,11,72,20,17,2015
Pittsburgh,Cleveland,01/03/2016,Pete Morelli,17,92,9,45,8,47,20,17,2015
Jacksonville,Houston,01/03/2016,Terry McAulay,16,108,7,53,9,55,18,17,2015
Tennessee,Indianapolis,01/03/2016,Clete Blakeman,12,131,6,60,6,71,13,17,2015
Oakland,Kansas City,01/03/2016,Tony Corrente,12,114,7,59,5,55,13,17,2015
Washington,Dallas,01/03/2016,John Parry,7,64,3,20,4,44,10,17,2015
Philadelphia,N.Y. Giants,01/03/2016,Gene Steratore,5,21,3,11,2,10,7,17,2015
Detroit,Chicago,01/03/2016,John Hussey,5,36,4,21,1,15,6,17,2015
Minnesota,Green Bay,01/03/2016,Bill Vinovich,12,91,5,37,7,54,13,17,2015
New Orleans,Atlanta,01/03/2016,Craig Wrolstad,8,77,4,45,4,32,10,17,2015
Tampa Bay,Carolina,01/03/2016,Jerome Boger,12,98,5,65,7,33,14,17,2015
San Diego,Denver,01/03/2016,Ron Torbert,13,80,7,45,6,35,15,17,2015
Seattle,Arizona,01/03/2016,Brad Allen,12,113,6,70,6,43,12,17,2015
St. Louis,San Francisco,01/03/2016,Walt Coleman,18,165,11,105,7,60,22,17,2015
Carolina,Denver,09/08/2016,Gene Steratore,12,107,8,85,4,22,17,1,2016
Tampa Bay,Atlanta,09/11/2016,Jeff Triplette,13,122,6,48,7,74,17,1,2016
Buffalo,Baltimore,09/11/2016,Brad Allen,14,124,8,89,6,35,16,1,2016
Chicago,Houston,09/11/2016,Pete Morelli,10,99,4,30,6,69,13,1,2016
Green Bay,Jacksonville,09/11/2016,Carl Cheffers,14,103,5,24,9,79,17,1,2016
San Diego,Kansas City,09/11/2016,Jerome Boger,11,76,5,30,6,46,18,1,2016
Oakland,New Orleans,09/11/2016,John Parry,21,194,14,141,7,53,23,1,2016
Cincinnati,N.Y. Jets,09/11/2016,Clete Blakeman,12,139,5,44,7,95,14,1,2016
Cleveland,Philadelphia,09/11/2016,Walt Anderson,11,61,4,15,7,46,12,1,2016
Minnesota,Tennessee,09/11/2016,Walt Coleman,5,49,3,39,2,10,8,1,2016
Miami,Seattle,09/11/2016,John Hussey,12,109,4,40,8,69,13,1,2016
N.Y. Giants,Dallas,09/11/2016,Ron Torbert,10,90,4,40,6,50,13,1,2016
Detroit,Indianapolis,09/11/2016,Ed Hochuli,13,115,8,70,5,45,15,1,2016
New England,Arizona,09/11/2016,Tony Corrente,14,127,8,69,6,58,19,1,2016
Pittsburgh,Washington,09/12/2016,Craig Wrolstad,13,136,4,81,9,55,14,1,2016
LA Rams,San Francisco,09/12/2016,Bill Vinovich,12,112,10,102,2,10,12,1,2016
N.Y. Jets,Buffalo,09/15/2016,Ed Hochuli,13,109,7,50,6,59,14,2,2016
San Francisco,Carolina,09/18/2016,John Parry,14,100,6,50,8,50,18,2,2016
Baltimore,Cleveland,09/18/2016,John Hussey,12,88,4,29,8,59,14,2,2016
Tennessee,Detroit,09/18/2016,Brad Allen,29,221,12,83,17,138,31,2,2016
Kansas City,Houston,09/18/2016,Tony Corrente,14,121,9,77,5,44,17,2,2016
Miami,New England,09/18/2016,Craig Wrolstad,12,114,5,49,7,65,12,2,2016
New Orleans,N.Y. Giants,09/18/2016,Gene Steratore,10,101,7,76,3,25,14,2,2016
Cincinnati,Pittsburgh,09/18/2016,Pete Morelli,10,85,5,31,5,54,13,2,2016
Dallas,Washington,09/18/2016,Bill Vinovich,14,90,6,39,8,51,16,2,2016
Tampa Bay,Arizona,09/18/2016,Ron Torbert,8,69,5,39,3,30,11,2,2016
Seattle,LA Rams,09/18/2016,Jerome Boger,19,192,10,114,9,78,24,2,2016
Indianapolis,Denver,09/18/2016,Walt Coleman,16,148,8,94,8,54,16,2,2016
Atlanta,Oakland,09/18/2016,Clete Blakeman,16,131,7,73,9,58,17,2,2016
Jacksonville,San Diego,09/18/2016,Carl Cheffers,16,116,13,93,3,23,17,2,2016
Green Bay,Minnesota,09/18/2016,Walt Anderson,19,209,6,72,13,137,21,2,2016
Philadelphia,Chicago,09/19/2016,Jeff Triplette,12,94,5,34,7,60,14,2,2016
Houston,New England,09/22/2016,Walt Coleman,9,58,6,43,3,15,10,3,2016
Arizona,Buffalo,09/25/2016,Walt Anderson,17,125,8,50,9,75,21,3,2016
Minnesota,Carolina,09/25/2016,Jerome Boger,16,107,6,42,10,65,20,3,2016
Denver,Cincinnati,09/25/2016,John Parry,14,110,5,41,9,69,20,3,2016
Detroit,Green Bay,09/25/2016,Carl Cheffers,8,131,4,86,4,45,10,3,2016
Baltimore,Jacksonville,09/25/2016,Gene Steratore,15,133,8,58,7,75,19,3,2016
Cleveland,Miami,09/25/2016,Clete Blakeman,21,158,13,91,8,67,23,3,2016
Washington,N.Y. Giants,09/25/2016,John Hussey,19,198,8,70,11,128,26,3,2016
Oakland,Tennessee,09/25/2016,Tony Corrente,16,128,8,58,8,70,18,3,2016
San Francisco,Seattle,09/25/2016,Jeff Triplette,10,85,4,35,6,50,12,3,2016
LA Rams,Tampa Bay,09/25/2016,Ed Hochuli,17,149,8,69,9,80,18,3,2016
Pittsburgh,Philadelphia,09/25/2016,Brad Allen,17,176,7,77,10,99,20,3,2016
San Diego,Indianapolis,09/25/2016,Ron Torbert,21,146,10,80,11,66,22,3,2016
N.Y. Jets,Kansas City,09/25/2016,Bill Vinovich,8,74,3,15,5,59,8,3,2016
Chicago,Dallas,09/25/2016,Craig Wrolstad,10,90,6,45,4,45,12,3,2016
Atlanta,New Orleans,09/26/2016,Pete Morelli,9,110,4,35,5,75,9,3,2016
Miami,Cincinnati,09/29/2016,Bill Vinovich,13,108,7,68,6,40,14,4,2016
Indianapolis,Jacksonville,10/02/2016,Walt Anderson,18,223,7,78,11,145,22,4,2016
Carolina,Atlanta,10/02/2016,John Hussey,14,132,6,55,8,77,18,4,2016
Oakland,Baltimore,10/02/2016,Ed Hochuli,22,198,12,93,10,105,25,4,2016
Detroit,Chicago,10/02/2016,Tony Corrente,18,131,10,76,8,55,22,4,2016
Tennessee,Houston,10/02/2016,Clete Blakeman,17,152,11,93,6,59,19,4,2016
Buffalo,New England,10/02/2016,Pete Morelli,15,134,6,60,9,74,24,4,2016
Seattle,N.Y. Jets,10/02/2016,Carl Cheffers,14,131,7,71,7,60,16,4,2016
Cleveland,Washington,10/02/2016,Jeff Triplette,16,176,7,101,9,75,22,4,2016
Denver,Tampa Bay,10/02/2016,Jerome Boger,18,157,9,88,9,69,19,4,2016
LA Rams,Arizona,10/02/2016,Gene Steratore,15,129,9,84,6,45,18,4,2016
New Orleans,San Diego,10/02/2016,Walt Coleman,11,80,6,34,5,46,13,4,2016
Dallas,San Francisco,10/02/2016,Terry McAulay,11,77,6,45,5,32,11,4,2016
Kansas City,Pittsburgh,10/02/2016,Ron Torbert,16,108,7,40,9,68,17,4,2016
N.Y. Giants,Minnesota,10/03/2016,Brad Allen,14,106,8,69,6,37,15,4,2016
Arizona,San Francisco,10/06/2016,Carl Cheffers,11,84,7,50,4,34,15,5,2016
Washington,Baltimore,10/09/2016,Ron Torbert,13,111,4,46,9,65,14,5,2016
New England,Cleveland,10/09/2016,Bill Vinovich,10,96,5,61,5,35,13,5,2016
Philadelphia,Detroit,10/09/2016,Pete Morelli,16,129,14,111,2,18,17,5,2016
Chicago,Indianapolis,10/09/2016,John Hussey,19,148,10,80,9,68,20,5,2016
Tennessee,Miami,10/09/2016,Craig Wrolstad,13,123,5,40,8,83,16,5,2016
Houston,Minnesota,10/09/2016,Jeff Triplette,13,112,4,15,9,97,14,5,2016
N.Y. Jets,Pittsburgh,10/09/2016,John Parry,5,28,4,18,1,10,10,5,2016
Atlanta,Denver,10/09/2016,Terry McAulay,15,135,7,78,8,57,17,5,2016
Cincinnati,Dallas,10/09/2016,Tony Corrente,13,94,6,49,7,45,13,5,2016
Buffalo,LA Rams,10/09/2016,Walt Coleman,13,100,7,60,6,40,14,5,2016
San Diego,Oakland,10/09/2016,Gene Steratore,10,74,4,38,6,36,11,5,2016
N.Y. Giants,Green Bay,10/09/2016,Ed Hochuli,12,108,6,51,6,57,18,5,2016
Tampa Bay,Carolina,10/10/2016,Clete Blakeman,12,100,5,40,7,60,13,5,2016
Denver,San Diego,10/13/2016,Craig Wrolstad,15,123,12,103,3,20,16,6,2016
San Francisco,Buffalo,10/16/2016,Gene Steratore,13,123,6,52,7,71,14,6,2016
Jacksonville,Chicago,10/16/2016,Clete Blakeman,15,137,5,50,10,87,18,6,2016
LA Rams,Detroit,10/16/2016,John Hussey,15,124,8,62,7,62,19,6,2016
Pittsburgh,Miami,10/16/2016,Ed Hochuli,14,160,6,65,8,95,18,6,2016
Cincinnati,New England,10/16/2016,Ron Torbert,13,101,7,46,6,55,13,6,2016
Carolina,New Orleans,10/16/2016,Walt Anderson,15,177,5,51,10,126,19,6,2016
Baltimore,N.Y. Giants,10/16/2016,Jeff Triplette,22,230,15,111,7,119,23,6,2016
Cleveland,Tennessee,10/16/2016,Carl Cheffers,18,165,11,69,7,96,20,6,2016
Philadelphia,Washington,10/16/2016,John Parry,22,189,13,114,9,75,23,6,2016
Kansas City,Oakland,10/16/2016,Pete Morelli,5,35,2,10,3,25,9,6,2016
Dallas,Green Bay,10/16/2016,Brad Allen,12,83,7,60,5,23,12,6,2016
Atlanta,Seattle,10/16/2016,Tony Corrente,11,96,8,66,3,30,11,6,2016
Indianapolis,Houston,10/16/2016,Bill Vinovich,14,101,7,42,7,59,16,6,2016
N.Y. Jets,Arizona,10/17/2016,Jerome Boger,19,147,10,83,9,64,23,6,2016
Chicago,Green Bay,10/20/2016,John Parry,19,164,10,108,9,56,21,7,2016
N.Y. Giants,LA Rams,10/23/2016,Ron Torbert,11,76,3,33,8,43,16,7,2016
Cleveland,Cincinnati,10/23/2016,Ed Hochuli,8,65,5,35,3,30,9,7,2016
Washington,Detroit,10/23/2016,Walt Coleman,8,50,4,20,4,30,9,7,2016
Oakland,Jacksonville,10/23/2016,Jeff Triplette,24,239,11,117,13,122,35,7,2016
New Orleans,Kansas City,10/23/2016,Clete Blakeman,14,105,10,75,4,30,17,7,2016
Buffalo,Miami,10/23/2016,Brad Allen,19,161,6,45,13,116,25,7,2016
Baltimore,N.Y. Jets,10/23/2016,Walt Anderson,8,60,4,35,4,25,8,7,2016
Minnesota,Philadelphia,10/23/2016,John Hussey,14,109,7,56,7,53,18,7,2016
Indianapolis,Tennessee,10/23/2016,Jerome Boger,18,169,12,131,6,38,18,7,2016
San Diego,Atlanta,10/23/2016,Bill Vinovich,12,84,3,14,9,70,14,7,2016
Tampa Bay,San Francisco,10/23/2016,Pete Morelli,11,109,7,78,4,31,14,7,2016
New England,Pittsburgh,10/23/2016,Craig Wrolstad,14,125,4,40,10,85,17,7,2016
Seattle,Arizona,10/23/2016,Terry McAulay,16,135,10,90,6,45,24,7,2016
Houston,Denver,10/24/2016,Carl Cheffers,9,98,2,15,7,83,12,7,2016
Jacksonville,Tennessee,10/27/2016,John Hussey,14,129,7,75,7,54,15,8,2016
Washington,Cincinnati,10/30/2016,Carl Cheffers,22,191,15,106,7,85,28,8,2016
Green Bay,Atlanta,10/30/2016,Walt Anderson,13,114,6,68,7,46,17,8,2016
New England,Buffalo,10/30/2016,John Parry,22,200,10,116,12,84,23,8,2016
N.Y. Jets,Cleveland,10/30/2016,Pete Morelli,7,47,5,37,2,10,8,8,2016
Detroit,Houston,10/30/2016,Brad Allen,14,124,8,75,6,49,16,8,2016
Kansas City,Indianapolis,10/30/2016,Craig Wrolstad,11,85,6,40,5,45,12,8,2016
Seattle,New Orleans,10/30/2016,Ed Hochuli,13,86,11,76,2,10,14,8,2016
Oakland,Tampa Bay,10/30/2016,Terry McAulay,29,264,23,200,6,64,34,8,2016
San Diego,Denver,10/30/2016,Tony Corrente,14,97,8,52,6,45,20,8,2016
Arizona,Carolina,10/30/2016,Walt Coleman,15,128,10,88,5,40,20,8,2016
Philadelphia,Dallas,10/30/2016,Jerome Boger,16,124,5,40,11,84,18,8,2016
Minnesota,Chicago,10/31/2016,Gene Steratore,3,30,1,10,2,20,5,8,2016
Atlanta,Tampa Bay,11/03/2016,Ron Torbert,17,119,6,34,11,85,21,9,2016
Denver,Oakland,11/06/2016,Clete Blakeman,20,176,12,104,8,72,22,9,2016
Pittsburgh,Baltimore,11/06/2016,John Hussey,23,193,13,99,10,94,25,9,2016
Dallas,Cleveland,11/06/2016,Jeff Triplette,9,71,4,38,5,33,14,9,2016
Jacksonville,Kansas City,11/06/2016,Gene Steratore,13,121,5,46,8,75,15,9,2016
N.Y. Jets,Miami,11/06/2016,Walt Coleman,18,163,10,77,8,86,25,9,2016
Detroit,Minnesota,11/06/2016,Ed Hochuli,14,111,6,57,8,54,14,9,2016
Philadelphia,N.Y. Giants,11/06/2016,Bill Vinovich,9,73,4,43,5,30,12,9,2016
Carolina,LA Rams,11/06/2016,Terry McAulay,15,144,5,35,10,109,17,9,2016
New Orleans,San Francisco,11/06/2016,Jerome Boger,13,118,4,40,9,78,15,9,2016
Indianapolis,Green Bay,11/06/2016,Tony Corrente,8,60,4,35,4,25,13,9,2016
Tennessee,San Diego,11/06/2016,Brad Allen,22,164,8,57,14,107,25,9,2016
Buffalo,Seattle,11/07/2016,Walt Anderson,21,190,11,115,10,75,23,9,2016
Cleveland,Baltimore,11/10/2016,Jerome Boger,9,96,3,35,6,61,12,10,2016
Kansas City,Carolina,11/13/2016,Carl Cheffers,15,98,9,45,6,53,15,10,2016
Houston,Jacksonville,11/13/2016,Ron Torbert,8,137,4,89,4,48,14,10,2016
Denver,New Orleans,11/13/2016,Bill Vinovich,4,35,1,10,3,25,6,10,2016
LA Rams,N.Y. Jets,11/13/2016,Ed Hochuli,11,86,7,55,4,31,13,10,2016
Atlanta,Philadelphia,11/13/2016,Craig Wrolstad,18,144,8,67,10,77,18,10,2016
Chicago,Tampa Bay,11/13/2016,Walt Coleman,18,159,9,74,9,85,19,10,2016
Green Bay,Tennessee,11/13/2016,Jeff Triplette,19,172,12,107,7,65,26,10,2016
Minnesota,Washington,11/13/2016,Pete Morelli,8,70,4,35,4,35,9,10,2016
Miami,San Diego,11/13/2016,Terry McAulay,15,110,11,81,4,29,20,10,2016
San Francisco,Arizona,11/13/2016,Brad Allen,11,110,9,100,2,10,14,10,2016
Dallas,Pittsburgh,11/13/2016,Clete Blakeman,14,138,10,98,4,40,18,10,2016
Seattle,New England,11/13/2016,Gene Steratore,15,121,8,60,7,61,16,10,2016
Cincinnati,N.Y. Giants,11/14/2016,John Parry,11,75,9,60,2,15,12,10,2016
New Orleans,Carolina,11/17/2016,Pete Morelli,12,93,6,48,6,45,14,11,2016
Buffalo,Cincinnati,11/20/2016,Terry McAulay,13,100,9,75,4,25,19,11,2016
Pittsburgh,Cleveland,11/20/2016,Brad Allen,17,122,8,70,9,52,17,11,2016
Baltimore,Dallas,11/20/2016,John Parry,17,181,12,136,5,45,17,11,2016
Jacksonville,Detroit,11/20/2016,Bill Vinovich,9,57,4,25,5,32,11,11,2016
Tennessee,Indianapolis,11/20/2016,Walt Anderson,19,179,11,109,8,70,21,11,2016
Tampa Bay,Kansas City,11/20/2016,Ed Hochuli,12,72,7,42,5,30,12,11,2016
Arizona,Minnesota,11/20/2016,Clete Blakeman,18,169,8,96,10,73,19,11,2016
Chicago,N.Y. Giants,11/20/2016,Craig Wrolstad,9,75,5,40,4,35,9,11,2016
Miami,LA Rams,11/20/2016,Gene Steratore,16,152,8,82,8,70,24,11,2016
New England,San Francisco,11/20/2016,Jeff Triplette,15,108,5,40,10,68,16,11,2016
Philadelphia,Seattle,11/20/2016,Carl Cheffers,15,96,8,48,7,48,19,11,2016
Green Bay,Washington,11/20/2016,John Hussey,12,99,6,59,6,40,15,11,2016
Houston,Oakland,11/21/2016,Tony Corrente,11,122,7,101,4,21,15,11,2016
Minnesota,Detroit,11/24/2016,Carl Cheffers,9,56,5,40,4,16,10,12,2016
Washington,Dallas,11/24/2016,Craig Wrolstad,6,55,3,30,3,25,9,12,2016
Pittsburgh,Indianapolis,11/24/2016,Walt Coleman,9,77,7,67,2,10,11,12,2016
Arizona,Atlanta,11/27/2016,John Parry,12,83,8,60,4,23,12,12,2016
Cincinnati,Baltimore,11/27/2016,Clete Blakeman,10,84,2,15,8,69,13,12,2016
Jacksonville,Buffalo,11/27/2016,Tony Corrente,12,91,6,60,6,31,12,12,2016
Tennessee,Chicago,11/27/2016,Ed Hochuli,13,166,6,118,7,48,13,12,2016
N.Y. Giants,Cleveland,11/27/2016,Walt Anderson,14,135,9,100,5,35,15,12,2016
San Diego,Houston,11/27/2016,Jeff Triplette,19,136,10,78,9,58,23,12,2016
San Francisco,Miami,11/27/2016,Ron Torbert,11,107,7,65,4,42,14,12,2016
LA Rams,New Orleans,11/27/2016,John Hussey,12,107,6,62,6,45,17,12,2016
Seattle,Tampa Bay,11/27/2016,Bill Vinovich,9,95,2,27,7,68,11,12,2016
Kansas City,Denver,11/27/2016,Pete Morelli,24,168,9,71,15,97,26,12,2016
Carolina,Oakland,11/27/2016,Jerome Boger,14,113,7,67,7,46,17,12,2016
New England,N.Y. Jets,11/27/2016,Brad Allen,8,81,2,15,6,66,10,12,2016
Green Bay,Philadelphia,11/28/2016,Terry McAulay,14,93,7,51,7,42,16,12,2016
Dallas,Minnesota,12/01/2016,Tony Corrente,18,135,10,78,8,57,20,13,2016
Kansas City,Atlanta,12/04/2016,Walt Coleman,18,158,13,128,5,30,21,13,2016
Miami,Baltimore,12/04/2016,Carl Cheffers,14,125,7,57,7,68,16,13,2016
San Francisco,Chicago,12/04/2016,Pete Morelli,16,146,11,106,5,40,17,13,2016
Philadelphia,Cincinnati,12/04/2016,Jeff Triplette,13,111,10,88,3,23,13,13,2016
Houston,Green Bay,12/04/2016,Gene Steratore,7,42,3,12,4,30,7,13,2016
Denver,Jacksonville,12/04/2016,Craig Wrolstad,10,97,4,32,6,65,10,13,2016
LA Rams,New England,12/04/2016,Jerome Boger,12,76,4,30,8,46,14,13,2016
Detroit,New Orleans,12/04/2016,Clete Blakeman,16,122,6,39,10,83,20,13,2016
Buffalo,Oakland,12/04/2016,Bill Vinovich,15,138,8,73,7,65,15,13,2016
Washington,Arizona,12/04/2016,Walt Anderson,13,86,7,35,6,51,13,13,2016
N.Y. Giants,Pittsburgh,12/04/2016,Terry McAulay,16,139,4,24,12,115,19,13,2016
Tampa Bay,San Diego,12/04/2016,John Hussey,12,80,6,35,6,45,14,13,2016
Carolina,Seattle,12/04/2016,John Parry,12,100,6,63,6,37,16,13,2016
Indianapolis,N.Y. Jets,12/05/2016,Ron Torbert,9,118,3,28,6,90,9,13,2016
Oakland,Kansas City,12/08/2016,Terry McAulay,19,155,10,82,9,73,21,14,2016
Pittsburgh,Buffalo,12/11/2016,Pete Morelli,13,91,6,45,7,46,15,14,2016
San Diego,Carolina,12/11/2016,Ron Torbert,12,67,7,32,5,35,16,14,2016
Cincinnati,Cleveland,12/11/2016,Gene Steratore,11,77,6,43,5,34,13,14,2016
Chicago,Detroit,12/11/2016,Jeff Triplette,18,194,11,139,7,55,22,14,2016
Houston,Indianapolis,12/11/2016,Brad Allen,16,183,7,124,9,59,19,14,2016
Minnesota,Jacksonville,12/11/2016,John Hussey,21,207,7,93,14,114,24,14,2016
Arizona,Miami,12/11/2016,Jerome Boger,21,172,7,54,14,118,23,14,2016
Washington,Philadelphia,12/11/2016,Tony Corrente,10,140,5,86,5,54,10,14,2016
New Orleans,Tampa Bay,12/11/2016,Walt Anderson,20,169,13,104,7,65,23,14,2016
Denver,Tennessee,12/11/2016,John Parry,14,142,9,87,5,55,15,14,2016
N.Y. Jets,San Francisco,12/11/2016,Craig Wrolstad,12,81,9,56,3,25,16,14,2016
Seattle,Green Bay,12/11/2016,Walt Coleman,12,113,7,63,5,50,14,14,2016
Atlanta,LA Rams,12/11/2016,Clete Blakeman,16,145,5,40,11,105,19,14,2016
Dallas,N.Y. Giants,12/11/2016,Carl Cheffers,12,104,5,54,7,50,13,14,2016
Baltimore,New England,12/12/2016,Ed Hochuli,13,95,8,47,5,48,13,14,2016
LA Rams,Seattle,12/15/2016,Brad Allen,21,162,8,76,13,86,22,15,2016
Miami,N.Y. Jets,12/17/2016,Pete Morelli,12,112,9,70,3,42,14,15,2016
Philadelphia,Baltimore,12/18/2016,Craig Wrolstad,10,92,3,30,7,62,12,15,2016
Cleveland,Buffalo,12/18/2016,Clete Blakeman,9,93,4,51,5,42,11,15,2016
Green Bay,Chicago,12/18/2016,Ron Torbert,14,104,8,64,6,40,15,15,2016
Tampa Bay,Dallas,12/18/2016,Terry McAulay,11,126,3,35,8,91,11,15,2016
Jacksonville,Houston,12/18/2016,Ed Hochuli,18,162,12,91,6,71,21,15,2016
Tennessee,Kansas City,12/18/2016,John Hussey,7,65,2,25,5,40,11,15,2016
Indianapolis,Minnesota,12/18/2016,Jerome Boger,11,82,5,55,6,27,12,15,2016
Detroit,N.Y. Giants,12/18/2016,Tony Corrente,7,61,2,15,5,46,9,15,2016
New Orleans,Arizona,12/18/2016,Carl Cheffers,12,98,5,46,7,52,14,15,2016
San Francisco,Atlanta,12/18/2016,Gene Steratore,8,47,4,20,4,27,8,15,2016
New England,Denver,12/18/2016,Walt Anderson,9,79,4,30,5,49,15,15,2016
Oakland,San Diego,12/18/2016,John Parry,8,59,2,15,6,44,8,15,2016
Pittsburgh,Cincinnati,12/18/2016,Bill Vinovich,15,190,7,104,8,86,16,15,2016
Carolina,Washington,12/19/2016,Walt Coleman,13,132,6,62,7,70,15,15,2016
N.Y. Giants,Philadelphia,12/22/2016,Clete Blakeman,6,55,5,50,1,5,7,16,2016
Miami,Buffalo,12/24/2016,Craig Wrolstad,7,50,2,15,5,35,7,16,2016
Atlanta,Carolina,12/24/2016,Bill Vinovich,10,69,6,45,4,24,10,16,2016
Washington,Chicago,12/24/2016,Brad Allen,11,125,7,73,4,52,15,16,2016
San Diego,Cleveland,12/24/2016,Walt Coleman,13,136,9,92,4,44,15,16,2016
Minnesota,Green Bay,12/24/2016,Jeff Triplette,11,91,8,70,3,21,12,16,2016
Tennessee,Jacksonville,12/24/2016,Pete Morelli,10,94,6,49,4,45,11,16,2016
N.Y. Jets,New England,12/24/2016,Gene Steratore,9,97,6,77,3,20,10,16,2016
Indianapolis,Oakland,12/24/2016,Ed Hochuli,14,115,4,22,10,93,17,16,2016
San Francisco,LA Rams,12/24/2016,Walt Anderson,16,145,11,100,5,45,20,16,2016
Arizona,Seattle,12/24/2016,Ron Torbert,12,125,7,85,5,40,15,16,2016
Cincinnati,Houston,12/24/2016,Carl Cheffers,9,85,6,60,3,25,13,16,2016
Baltimore,Pittsburgh,12/25/2016,John Parry,11,140,7,95,4,45,14,16,2016
Denver,Kansas City,12/25/2016,Tony Corrente,17,135,9,70,8,65,21,16,2016
Detroit,Dallas,12/26/2016,John Hussey,13,109,5,62,8,47,17,16,2016
New Orleans,Atlanta,01/01/2017,Ron Torbert,15,133,6,70,9,63,15,17,2016
Baltimore,Cincinnati,01/01/2017,Pete Morelli,6,61,4,41,2,20,9,17,2016
Green Bay,Detroit,01/01/2017,Jerome Boger,15,105,10,75,5,30,20,17,2016
Jacksonville,Indianapolis,01/01/2017,Clete Blakeman,12,89,8,54,4,35,12,17,2016
New England,Miami,01/01/2017,John Parry,16,137,7,64,9,73,18,17,2016
Chicago,Minnesota,01/01/2017,Terry McAulay,8,64,6,49,2,15,10,17,2016
Buffalo,N.Y. Jets,01/01/2017,Jeff Triplette,2,15,0,0,2,15,4,17,2016
Dallas,Philadelphia,01/01/2017,Walt Coleman,9,96,5,35,4,61,11,17,2016
Cleveland,Pittsburgh,01/01/2017,John Hussey,14,80,5,37,9,43,15,17,2016
Carolina,Tampa Bay,01/01/2017,Carl Cheffers,9,75,4,45,5,30,10,17,2016
Houston,Tennessee,01/01/2017,Bill Vinovich,13,85,6,35,7,50,14,17,2016
N.Y. Giants,Washington,01/01/2017,Gene Steratore,10,84,5,42,5,42,11,17,2016
Oakland,Denver,01/01/2017,Brad Allen,18,168,13,125,5,43,19,17,2016
Arizona,LA Rams,01/01/2017,Craig Wrolstad,13,112,4,51,9,61,16,17,2016
Kansas City,San Diego,01/01/2017,Walt Anderson,14,69,4,19,10,50,16,17,2016
Seattle,San Francisco,01/01/2017,Tony Corrente,8,59,4,34,4,25,8,17,2016
Kansas City,New England,09/07/2017,Bill Vinovich,21,194,15,139,6,55,26,1,2017
N.Y. Jets,Buffalo,09/10/2017,John Hussey,11,112,5,62,6,50,14,1,2017
Atlanta,Chicago,09/10/2017,Jeff Triplette,12,113,8,73,4,40,12,1,2017
Baltimore,Cincinnati,09/10/2017,Walt Coleman,20,151,11,85,9,66,22,1,2017
Pittsburgh,Cleveland,09/10/2017,Craig Wrolstad,17,205,13,144,4,61,17,1,2017
Arizona,Detroit,09/10/2017,Walt Anderson,17,155,7,55,10,100,25,1,2017
Jacksonville,Houston,09/10/2017,Tony Corrente,19,183,10,89,9,94,19,1,2017
Oakland,Tennessee,09/10/2017,Jerome Boger,10,98,5,49,5,49,10,1,2017
Philadelphia,Washington,09/10/2017,Brad Allen,10,91,8,76,2,15,12,1,2017
Indianapolis,LA Rams,09/10/2017,Ron Torbert,11,70,4,20,7,50,16,1,2017
Seattle,Green Bay,09/10/2017,John Parry,16,120,8,50,8,70,24,1,2017
Carolina,San Francisco,09/10/2017,Clete Blakeman,15,114,5,40,10,74,17,1,2017
N.Y. Giants,Dallas,09/10/2017,Carl Cheffers,11,105,6,55,5,50,12,1,2017
New Orleans,Minnesota,09/11/2017,Gene Steratore,11,102,6,52,5,50,15,1,2017
LA Chargers,Denver,09/11/2017,Terry McAulay,7,102,4,40,3,62,9,1,2017
Houston,Cincinnati,09/14/2017,Clete Blakeman,16,106,9,61,7,45,18,2,2017
Cleveland,Baltimore,09/17/2017,Gene Steratore,18,110,11,65,7,45,20,2,2017
Buffalo,Carolina,09/17/2017,Walt Coleman,11,84,5,44,6,40,12,2,2017
Arizona,Indianapolis,09/17/2017,Carl Cheffers,14,111,6,41,8,70,19,2,2017
Tennessee,Jacksonville,09/17/2017,Ed Hochuli,17,169,7,70,10,99,18,2,2017
Philadelphia,Kansas City,09/17/2017,Terry McAulay,9,70,4,30,5,40,13,2,2017
New England,New Orleans,09/17/2017,Craig Wrolstad,14,101,9,66,5,35,15,2,2017
Minnesota,Pittsburgh,09/17/2017,Pete Morelli,21,203,11,131,10,72,25,2,2017
Chicago,Tampa Bay,09/17/2017,Ron Torbert,12,93,8,59,4,34,13,2,2017
Miami,LA Chargers,09/17/2017,Tony Corrente,11,79,5,23,6,56,14,2,2017
N.Y. Jets,Oakland,09/17/2017,Jeff Triplette,14,126,5,47,9,79,14,2,2017
Dallas,Denver,09/17/2017,Brad Allen,16,130,8,69,8,61,20,2,2017
Washington,LA Rams,09/17/2017,Jerome Boger,11,100,4,25,7,75,18,2,2017
San Francisco,Seattle,09/17/2017,Bill Vinovich,15,137,6,66,9,71,17,2,2017
Green Bay,Atlanta,09/17/2017,Walt Anderson,16,104,10,70,6,34,19,2,2017
Detroit,N.Y. Giants,09/18/2017,John Parry,13,100,6,50,7,50,14,2,2017
LA Rams,San Francisco,09/21/2017,Jeff Triplette,17,107,7,52,10,55,20,3,2017
Baltimore,Jacksonville,09/24/2017,Pete Morelli,19,158,10,88,9,70,21,3,2017
Denver,Buffalo,09/24/2017,Carl Cheffers,18,148,10,79,8,69,19,3,2017
New Orleans,Carolina,09/24/2017,Bill Vinovich,2,15,1,10,1,5,3,3,2017
Pittsburgh,Chicago,09/24/2017,Clete Blakeman,16,113,6,40,10,73,19,3,2017
Atlanta,Detroit,09/24/2017,Walt Coleman,17,166,8,68,9,98,21,3,2017
Cleveland,Indianapolis,09/24/2017,Ed Hochuli,21,212,10,113,11,99,22,3,2017
Tampa Bay,Minnesota,09/24/2017,John Hussey,12,90,7,37,5,53,18,3,2017
Houston,New England,09/24/2017,John Parry,15,129,10,60,5,69,17,3,2017
Miami,N.Y. Jets,09/24/2017,Terry McAulay,18,145,8,51,10,94,21,3,2017
N.Y. Giants,Philadelphia,09/24/2017,Jerome Boger,19,240,10,137,9,103,22,3,2017
Seattle,Tennessee,09/24/2017,Ron Torbert,16,143,11,98,5,45,27,3,2017
Cincinnati,Green Bay,09/24/2017,Gene Steratore,11,101,7,68,4,33,13,3,2017
Kansas City,LA Chargers,09/24/2017,Walt Anderson,21,183,13,122,8,61,25,3,2017
Oakland,Washington,09/24/2017,Tony Corrente,14,112,4,35,10,77,17,3,2017
Dallas,Arizona,09/25/2017,Craig Wrolstad,15,126,9,76,6,50,17,3,2017
Chicago,Green Bay,09/28/2017,John Hussey,15,117,8,62,7,55,18,4,2017
New Orleans,Miami,10/01/2017,Ed Hochuli,19,161,8,71,11,90,26,4,2017
Buffalo,Atlanta,10/01/2017,Terry McAulay,13,100,9,55,4,45,15,4,2017
Pittsburgh,Baltimore,10/01/2017,Walt Anderson,14,115,8,60,6,55,18,4,2017
Cincinnati,Cleveland,10/01/2017,Ron Torbert,12,94,8,66,4,28,14,4,2017
LA Rams,Dallas,10/01/2017,Clete Blakeman,11,86,7,41,4,45,15,4,2017
Tennessee,Houston,10/01/2017,Jeff Triplette,9,108,6,88,3,20,14,4,2017
Detroit,Minnesota,10/01/2017,Bill Vinovich,8,70,6,60,2,10,9,4,2017
Carolina,New England,10/01/2017,Jerome Boger,8,88,1,33,7,55,9,4,2017
Jacksonville,N.Y. Jets,10/01/2017,Gene Steratore,16,117,6,47,10,70,17,4,2017
San Francisco,Arizona,10/01/2017,Tony Corrente,23,193,13,113,10,80,26,4,2017
Philadelphia,LA Chargers,10/01/2017,Carl Cheffers,18,97,9,58,9,39,20,4,2017
N.Y. Giants,Tampa Bay,10/01/2017,Craig Wrolstad,5,19,1,0,4,19,10,4,2017
Oakland,Denver,10/01/2017,John Parry,13,115,7,75,6,40,18,4,2017
Indianapolis,Seattle,10/01/2017,Brad Allen,11,76,5,31,6,45,15,4,2017
Washington,Kansas City,10/02/2017,Walt Coleman,10,59,7,44,3,15,12,4,2017
New England,Tampa Bay,10/05/2017,Carl Cheffers,21,178,12,108,9,70,22,5,2017
Buffalo,Cincinnati,10/08/2017,Pete Morelli,12,142,6,71,6,71,13,5,2017
N.Y. Jets,Cleveland,10/08/2017,Walt Anderson,15,140,9,80,6,60,17,5,2017
Carolina,Detroit,10/08/2017,Craig Wrolstad,12,110,11,100,1,10,18,5,2017
San Francisco,Indianapolis,10/08/2017,Walt Coleman,17,139,10,77,7,62,18,5,2017
Tennessee,Miami,10/08/2017,Bill Vinovich,16,100,11,77,5,23,19,5,2017
LA Chargers,N.Y. Giants,10/08/2017,Jeff Triplette,21,154,11,87,10,67,27,5,2017
Arizona,Philadelphia,10/08/2017,John Hussey,12,121,7,61,5,60,14,5,2017
Jacksonville,Pittsburgh,10/08/2017,John Parry,9,56,4,19,5,37,11,5,2017
Seattle,LA Rams,10/08/2017,Gene Steratore,12,85,7,40,5,45,14,5,2017
Baltimore,Oakland,10/08/2017,Brad Allen,4,29,1,5,3,24,4,5,2017
Green Bay,Dallas,10/08/2017,Terry McAulay,13,108,6,38,7,70,16,5,2017
Kansas City,Houston,10/08/2017,Ron Torbert,13,123,6,64,7,59,17,5,2017
Minnesota,Chicago,10/09/2017,Jerome Boger,17,124,9,69,8,55,20,5,2017
Philadelphia,Carolina,10/12/2017,Pete Morelli,11,127,10,126,1,1,14,6,2017
Miami,Atlanta,10/15/2017,John Hussey,10,115,4,42,6,73,13,6,2017
Chicago,Baltimore,10/15/2017,Ed Hochuli,13,113,5,44,8,69,15,6,2017
Cleveland,Houston,10/15/2017,Brad Allen,15,116,11,72,4,44,19,6,2017
Green Bay,Minnesota,10/15/2017,Ron Torbert,15,157,8,92,7,65,17,6,2017
Detroit,New Orleans,10/15/2017,Jeff Triplette,20,164,7,46,13,118,24,6,2017
New England,N.Y. Jets,10/15/2017,Tony Corrente,12,114,6,45,6,69,14,6,2017
San Francisco,Washington,10/15/2017,John Parry,12,83,7,40,5,43,13,6,2017
Tampa Bay,Arizona,10/15/2017,Gene Steratore,16,110,9,49,7,61,19,6,2017
LA Rams,Jacksonville,10/15/2017,Walt Coleman,12,110,7,70,5,40,13,6,2017
Pittsburgh,Kansas City,10/15/2017,Carl Cheffers,13,105,6,57,7,48,15,6,2017
LA Chargers,Oakland,10/15/2017,Clete Blakeman,9,72,4,32,5,40,10,6,2017
N.Y. Giants,Denver,10/15/2017,Bill Vinovich,10,123,5,77,5,46,13,6,2017
Indianapolis,Tennessee,10/16/2017,Walt Anderson,9,96,5,51,4,45,11,6,2017
Kansas City,Oakland,10/19/2017,Craig Wrolstad,18,205,8,108,10,97,19,7,2017
Tampa Bay,Buffalo,10/22/2017,Clete Blakeman,9,90,5,55,4,35,10,7,2017
Carolina,Chicago,10/22/2017,Walt Anderson,9,75,4,35,5,40,10,7,2017
Tennessee,Cleveland,10/22/2017,Terry McAulay,17,116,5,35,12,81,19,7,2017
New Orleans,Green Bay,10/22/2017,Jerome Boger,15,134,7,80,8,54,20,7,2017
Jacksonville,Indianapolis,10/22/2017,Jeff Triplette,9,89,4,34,5,55,11,7,2017
Arizona,LA Rams,10/22/2017,Brad Allen,16,110,10,65,6,45,20,7,2017
N.Y. Jets,Miami,10/22/2017,Walt Coleman,21,200,12,124,9,76,25,7,2017
Baltimore,Minnesota,10/22/2017,Carl Cheffers,7,62,3,15,4,47,8,7,2017
Cincinnati,Pittsburgh,10/22/2017,Bill Vinovich,6,59,5,54,1,5,6,7,2017
Dallas,San Francisco,10/22/2017,Ron Torbert,7,58,5,36,2,22,11,7,2017
Denver,LA Chargers,10/22/2017,John Hussey,19,149,10,68,9,81,20,7,2017
Seattle,N.Y. Giants,10/22/2017,Tony Corrente,22,138,15,110,7,28,23,7,2017
Atlanta,New England,10/22/2017,Gene Steratore,14,105,6,40,8,65,17,7,2017
Washington,Philadelphia,10/23/2017,Ed Hochuli,14,110,5,55,9,55,16,7,2017
Miami,Baltimore,10/26/2017,John Parry,12,83,7,43,5,40,17,8,2017
Minnesota,Cleveland,10/29/2017,Jeff Triplette,10,132,5,58,5,74,13,8,2017
Oakland,Buffalo,10/29/2017,Ed Hochuli,17,145,6,50,11,95,18,8,2017
Indianapolis,Cincinnati,10/29/2017,Jerome Boger,12,99,7,45,5,54,14,8,2017
LA Chargers,New England,10/29/2017,Pete Morelli,16,157,10,77,6,80,19,8,2017
Chicago,New Orleans,10/29/2017,Carl Cheffers,11,82,4,31,7,51,15,8,2017
Atlanta,N.Y. Jets,10/29/2017,Craig Wrolstad,12,118,6,68,6,50,15,8,2017
San Francisco,Philadelphia,10/29/2017,Clete Blakeman,10,104,6,69,4,35,12,8,2017
Carolina,Tampa Bay,10/29/2017,Walt Coleman,11,106,5,51,6,55,12,8,2017
Houston,Seattle,10/29/2017,Terry McAulay,18,213,8,93,10,120,22,8,2017
Dallas,Washington,10/29/2017,Walt Anderson,13,121,8,89,5,32,14,8,2017
Pittsburgh,Detroit,10/29/2017,John Hussey,11,94,5,37,6,57,12,8,2017
Denver,Kansas City,10/30/2017,Tony Corrente,14,122,7,53,7,69,18,8,2017
Buffalo,N.Y. Jets,11/02/2017,Jerome Boger,21,165,11,99,10,66,26,9,2017
Atlanta,Carolina,11/05/2017,Tony Corrente,13,99,8,70,5,29,15,9,2017
Indianapolis,Houston,11/05/2017,John Parry,13,142,6,68,7,74,16,9,2017
Cincinnati,Jacksonville,11/05/2017,Brad Allen,13,128,8,78,5,50,17,9,2017
Tampa Bay,New Orleans,11/05/2017,Bill Vinovich,11,78,7,50,4,28,11,9,2017
LA Rams,N.Y. Giants,11/05/2017,Ed Hochuli,10,107,6,55,4,52,10,9,2017
Denver,Philadelphia,11/05/2017,Gene Steratore,19,140,14,105,5,35,22,9,2017
Baltimore,Tennessee,11/05/2017,John Hussey,9,78,6,39,3,39,12,9,2017
Arizona,San Francisco,11/05/2017,Craig Wrolstad,10,78,2,25,8,53,14,9,2017
Washington,Seattle,11/05/2017,Ron Torbert,23,200,7,62,16,138,25,9,2017
Kansas City,Dallas,11/05/2017,Pete Morelli,13,117,8,52,5,65,13,9,2017
Oakland,Miami,11/05/2017,Terry McAulay,21,212,10,105,11,107,22,9,2017
Detroit,Green Bay,11/06/2017,Clete Blakeman,4,39,2,19,2,20,5,9,2017
Seattle,Arizona,11/09/2017,Walt Anderson,21,166,12,108,9,58,23,10,2017
New Orleans,Buffalo,11/12/2017,Terry McAulay,12,97,4,41,8,56,17,10,2017
Green Bay,Chicago,11/12/2017,Tony Corrente,13,113,5,35,8,78,17,10,2017
Cleveland,Detroit,11/12/2017,Carl Cheffers,14,141,7,60,7,81,16,10,2017
Pittsburgh,Indianapolis,11/12/2017,Clete Blakeman,18,152,9,70,9,82,19,10,2017
LA Chargers,Jacksonville,11/12/2017,Ron Torbert,16,183,7,77,9,106,21,10,2017
N.Y. Jets,Tampa Bay,11/12/2017,Brad Allen,14,127,8,77,6,50,15,10,2017
Cincinnati,Tennessee,11/12/2017,Jeff Triplette,17,139,12,84,5,55,19,10,2017
Minnesota,Washington,11/12/2017,Bill Vinovich,5,55,3,40,2,15,5,10,2017
Houston,LA Rams,11/12/2017,Pete Morelli,18,146,8,60,10,86,19,10,2017
Dallas,Atlanta,11/12/2017,Ed Hochuli,10,89,5,54,5,35,16,10,2017
N.Y. Giants,San Francisco,11/12/2017,Jerome Boger,10,79,4,35,6,44,13,10,2017
New England,Denver,11/12/2017,Walt Coleman,6,33,1,5,5,28,9,10,2017
Miami,Carolina,11/13/2017,Gene Steratore,13,94,7,57,6,37,14,10,2017
Tennessee,Pittsburgh,11/16/2017,Ron Torbert,16,126,9,65,7,61,18,11,2017
Detroit,Chicago,11/19/2017,Brad Allen,11,113,6,49,5,64,11,11,2017
Jacksonville,Cleveland,11/19/2017,Pete Morelli,6,40,6,40,0,0,7,11,2017
Baltimore,Green Bay,11/19/2017,Jeff Triplette,8,83,3,30,5,53,8,11,2017
Arizona,Houston,11/19/2017,Ed Hochuli,16,132,10,90,6,42,21,11,2017
LA Rams,Minnesota,11/19/2017,Walt Anderson,15,125,8,60,7,65,18,11,2017
Washington,New Orleans,11/19/2017,Walt Coleman,16,121,9,67,7,54,17,11,2017
Kansas City,N.Y. Giants,11/19/2017,Gene Steratore,14,135,9,87,5,48,16,11,2017
Buffalo,LA Chargers,11/19/2017,John Parry,7,61,6,48,1,13,8,11,2017
Cincinnati,Denver,11/19/2017,Craig Wrolstad,8,64,3,14,5,50,8,11,2017
New England,Oakland,11/19/2017,John Hussey,10,76,2,10,8,66,10,11,2017
Philadelphia,Dallas,11/19/2017,Bill Vinovich,5,40,3,30,2,10,6,11,2017
Tampa Bay,Miami,11/19/2017,Tony Corrente,26,205,9,82,17,123,30,11,2017
Atlanta,Seattle,11/20/2017,Carl Cheffers,16,175,7,69,9,106,21,11,2017
Minnesota,Detroit,11/23/2017,Tony Corrente,17,128,9,74,8,54,22,12,2017
LA Chargers,Dallas,11/23/2017,Jerome Boger,12,116,5,56,7,60,14,12,2017
N.Y. Giants,Washington,11/23/2017,Terry McAulay,14,134,6,79,8,55,19,12,2017
Tampa Bay,Atlanta,11/26/2017,Jeff Triplette,6,57,2,15,4,42,6,12,2017
Cleveland,Cincinnati,11/26/2017,John Hussey,11,104,7,69,4,35,12,12,2017
Tennessee,Indianapolis,11/26/2017,Craig Wrolstad,11,82,2,15,9,67,11,12,2017
Buffalo,Kansas City,11/26/2017,Bill Vinovich,12,100,6,50,6,50,12,12,2017
Miami,New England,11/26/2017,Ron Torbert,13,122,6,52,7,70,15,12,2017
Carolina,N.Y. Jets,11/26/2017,Carl Cheffers,17,152,10,84,7,68,17,12,2017
Chicago,Philadelphia,11/26/2017,Walt Coleman,20,126,9,56,11,70,20,12,2017
New Orleans,LA Rams,11/26/2017,John Parry,16,202,7,112,9,90,20,12,2017
Seattle,San Francisco,11/26/2017,Pete Morelli,13,109,6,35,7,74,15,12,2017
Jacksonville,Arizona,11/26/2017,Clete Blakeman,15,143,5,45,10,98,15,12,2017
Denver,Oakland,11/26/2017,Walt Anderson,16,143,9,75,7,68,20,12,2017
Green Bay,Pittsburgh,11/26/2017,Ed Hochuli,8,72,3,27,5,45,13,12,2017
Houston,Baltimore,11/27/2017,Brad Allen,13,125,6,36,7,89,16,12,2017
Washington,Dallas,11/30/2017,Craig Wrolstad,10,68,7,43,3,25,12,13,2017
Minnesota,Atlanta,12/03/2017,Brad Allen,13,106,6,51,7,55,15,13,2017
Detroit,Baltimore,12/03/2017,Jerome Boger,8,70,6,45,2,25,11,13,2017
New England,Buffalo,12/03/2017,Gene Steratore,12,100,9,66,3,34,18,13,2017
San Francisco,Chicago,12/03/2017,Ed Hochuli,12,82,8,53,4,29,14,13,2017
Tampa Bay,Green Bay,12/03/2017,Terry McAulay,15,121,8,74,7,47,19,13,2017
Indianapolis,Jacksonville,12/03/2017,Bill Vinovich,10,86,4,31,6,55,14,13,2017
Denver,Miami,12/03/2017,Carl Cheffers,16,142,9,57,7,85,21,13,2017
Carolina,New Orleans,12/03/2017,John Hussey,13,122,6,54,7,68,16,13,2017
Kansas City,N.Y. Jets,12/03/2017,John Parry,13,70,8,30,5,40,13,13,2017
Houston,Tennessee,12/03/2017,Clete Blakeman,18,148,11,85,7,63,22,13,2017
Cleveland,LA Chargers,12/03/2017,Walt Coleman,9,86,4,24,5,62,10,13,2017
LA Rams,Arizona,12/03/2017,Ron Torbert,11,61,7,36,4,25,14,13,2017
N.Y. Giants,Oakland,12/03/2017,Pete Morelli,7,47,1,5,6,42,9,13,2017
Philadelphia,Seattle,12/03/2017,Tony Corrente,12,110,7,64,5,46,14,13,2017
Pittsburgh,Cincinnati,12/04/2017,Walt Anderson,20,239,7,66,13,173,23,13,2017
New Orleans,Atlanta,12/07/2017,Clete Blakeman,15,122,11,87,4,35,18,14,2017
Indianapolis,Buffalo,12/10/2017,Brad Allen,4,30,2,20,2,10,5,14,2017
Minnesota,Carolina,12/10/2017,Terry McAulay,8,78,2,30,6,48,9,14,2017
Chicago,Cincinnati,12/10/2017,John Parry,17,130,10,74,7,56,18,14,2017
Green Bay,Cleveland,12/10/2017,Bill Vinovich,9,65,3,20,6,45,9,14,2017
San Francisco,Houston,12/10/2017,John Hussey,19,169,11,87,8,82,23,14,2017
Seattle,Jacksonville,12/10/2017,Gene Steratore,13,121,6,73,7,48,22,14,2017
Oakland,Kansas City,12/10/2017,Carl Cheffers,14,108,7,39,7,69,14,14,2017
Detroit,Tampa Bay,12/10/2017,Ed Hochuli,15,170,8,105,7,65,16,14,2017
Tennessee,Arizona,12/10/2017,Jerome Boger,11,78,6,48,5,30,15,14,2017
N.Y. Jets,Denver,12/10/2017,Tony Corrente,7,41,4,20,3,21,10,14,2017
Washington,LA Chargers,12/10/2017,Jeff Triplette,9,88,4,48,5,40,14,14,2017
Philadelphia,LA Rams,12/10/2017,Craig Wrolstad,17,169,10,67,7,102,17,14,2017
Dallas,N.Y. Giants,12/10/2017,Walt Anderson,15,120,8,51,7,69,15,14,2017
Baltimore,Pittsburgh,12/10/2017,Walt Coleman,11,136,5,35,6,101,18,14,2017
New England,Miami,12/11/2017,Pete Morelli,17,180,9,78,8,102,19,14,2017
Denver,Indianapolis,12/14/2017,Terry McAulay,16,119,12,80,4,39,19,15,2017
Chicago,Detroit,12/16/2017,Jeff Triplette,21,155,13,97,8,58,22,15,2017
LA Chargers,Kansas City,12/16/2017,Walt Anderson,16,132,9,61,7,71,19,15,2017
Miami,Buffalo,12/17/2017,Jerome Boger,10,88,7,60,3,28,13,15,2017
Green Bay,Carolina,12/17/2017,Craig Wrolstad,11,68,6,28,5,40,15,15,2017
Baltimore,Cleveland,12/17/2017,Clete Blakeman,13,92,7,57,6,35,14,15,2017
Houston,Jacksonville,12/17/2017,Carl Cheffers,22,181,14,127,8,54,26,15,2017
Cincinnati,Minnesota,12/17/2017,Walt Coleman,16,137,5,44,11,93,16,15,2017
N.Y. Jets,New Orleans,12/17/2017,Ron Torbert,16,142,8,50,8,92,17,15,2017
Philadelphia,N.Y. Giants,12/17/2017,Brad Allen,12,111,7,44,5,67,16,15,2017
Arizona,Washington,12/17/2017,Pete Morelli,15,153,8,71,7,82,15,15,2017
LA Rams,Seattle,12/17/2017,Ed Hochuli,12,85,3,25,9,60,18,15,2017
New England,Pittsburgh,12/17/2017,Tony Corrente,8,67,2,4,6,63,8,15,2017
Tennessee,San Francisco,12/17/2017,John Parry,10,92,3,22,7,70,11,15,2017
Dallas,Oakland,12/17/2017,Gene Steratore,21,205,7,100,14,105,23,15,2017
Atlanta,Tampa Bay,12/18/2017,John Hussey,13,113,6,60,7,53,14,15,2017
Indianapolis,Baltimore,12/23/2017,Tony Corrente,7,44,2,19,5,25,8,16,2017
Minnesota,Green Bay,12/23/2017,Carl Cheffers,8,89,2,10,6,79,10,16,2017
Tampa Bay,Carolina,12/24/2017,Jerome Boger,18,122,12,72,6,50,21,16,2017
Cleveland,Chicago,12/24/2017,Terry McAulay,12,85,8,60,4,25,14,16,2017
Detroit,Cincinnati,12/24/2017,Gene Steratore,14,134,9,74,5,60,14,16,2017
Miami,Kansas City,12/24/2017,Jeff Triplette,16,115,11,75,5,40,17,16,2017
Buffalo,New England,12/24/2017,Craig Wrolstad,6,93,4,83,2,10,9,16,2017
Atlanta,New Orleans,12/24/2017,Pete Morelli,13,121,10,91,3,30,16,16,2017
LA Chargers,N.Y. Jets,12/24/2017,Clete Blakeman,13,114,8,80,5,34,16,16,2017
LA Rams,Tennessee,12/24/2017,Brad Allen,10,98,5,44,5,54,14,16,2017
Denver,Washington,12/24/2017,Ed Hochuli,9,65,3,30,6,35,10,16,2017
Jacksonville,San Francisco,12/24/2017,Walt Anderson,20,167,12,99,8,68,20,16,2017
N.Y. Giants,Arizona,12/24/2017,John Parry,16,146,10,101,6,45,19,16,2017
Seattle,Dallas,12/24/2017,John Hussey,18,217,11,142,7,75,19,16,2017
Pittsburgh,Houston,12/25/2017,Bill Vinovich,11,104,4,24,7,80,13,16,2017
Oakland,Philadelphia,12/25/2017,Ron Torbert,15,110,7,50,8,60,17,16,2017
Carolina,Atlanta,12/31/2017,Bill Vinovich,12,95,5,35,7,60,12,17,2017
Cincinnati,Baltimore,12/31/2017,Ron Torbert,11,107,6,60,5,47,15,17,2017
Green Bay,Detroit,12/31/2017,Pete Morelli,13,130,8,68,5,62,14,17,2017
Houston,Indianapolis,12/31/2017,Gene Steratore,11,54,7,34,4,20,15,17,2017
Buffalo,Miami,12/31/2017,Jeff Triplette,20,190,6,45,14,145,26,17,2017
Chicago,Minnesota,12/31/2017,Craig Wrolstad,22,219,10,116,12,103,23,17,2017
N.Y. Jets,New England,12/31/2017,Brad Allen,13,133,9,84,4,49,14,17,2017
Washington,N.Y. Giants,12/31/2017,John Hussey,7,60,4,35,3,25,7,17,2017
Dallas,Philadelphia,12/31/2017,John Parry,14,113,7,64,7,49,16,17,2017
Cleveland,Pittsburgh,12/31/2017,Jerome Boger,12,92,9,77,3,15,13,17,2017
New Orleans,Tampa Bay,12/31/2017,Walt Anderson,9,53,7,38,2,15,10,17,2017
Jacksonville,Tennessee,12/31/2017,Tony Corrente,8,56,6,41,2,15,8,17,2017
Kansas City,Denver,12/31/2017,Clete Blakeman,8,70,4,40,4,30,10,17,2017
Oakland,LA Chargers,12/31/2017,Ed Hochuli,13,150,6,85,7,65,15,17,2017
San Francisco,LA Rams,12/31/2017,Terry McAulay,10,69,4,23,6,46,11,17,2017
Arizona,Seattle,12/31/2017,Walt Coleman,12,125,4,25,8,100,15,17,2017
Atlanta,Philadelphia,09/06/2018,John Hussey,26,236,15,135,11,101,28,1,2018
Buffalo,Baltimore,09/09/2018,Shawn Hochuli,19,178,10,100,9,78,24,1,2018
Pittsburgh,Cleveland,09/09/2018,Shawn Smith,23,203,12,116,11,87,29,1,2018
Cincinnati,Indianapolis,09/09/2018,Pete Morelli,15,185,8,94,7,91,17,1,2018
Tennessee,Miami,09/09/2018,Jerome Boger,12,99,5,48,7,51,17,1,2018
San Francisco,Minnesota,09/09/2018,Clay Martin,10,73,3,21,7,52,11,1,2018
Houston,New England,09/09/2018,Tony Corrente,12,80,6,44,6,36,13,1,2018
Tampa Bay,New Orleans,09/09/2018,John Parry,15,147,7,70,8,77,21,1,2018
Jacksonville,N.Y. Giants,09/09/2018,Craig Wrolstad,17,162,11,119,6,43,18,1,2018
Kansas City,LA Chargers,09/09/2018,Clete Blakeman,13,95,6,50,7,45,16,1,2018
Washington,Arizona,09/09/2018,Walt Coleman,18,130,9,63,9,67,21,1,2018
Dallas,Carolina,09/09/2018,Walt Anderson,19,165,10,85,9,80,21,1,2018
Seattle,Denver,09/09/2018,Brad Allen,14,105,7,45,7,60,16,1,2018
Chicago,Green Bay,09/09/2018,Carl Cheffers,13,107,5,35,8,72,14,1,2018
N.Y. Jets,Detroit,09/10/2018,Bill Vinovich,10,64,7,49,3,15,10,1,2018
LA Rams,Oakland,09/10/2018,Ron Torbert,19,225,8,70,11,155,20,1,2018
Baltimore,Cincinnati,09/13/2018,Walt Anderson,16,143,7,51,9,92,18,2,2018
Carolina,Atlanta,09/16/2018,Bill Vinovich,9,75,7,49,2,26,16,2,2018
LA Chargers,Buffalo,09/16/2018,Clay Martin,12,76,6,45,6,31,13,2,2018
Minnesota,Green Bay,09/16/2018,Tony Corrente,15,124,8,70,7,54,19,2,2018
Cleveland,New Orleans,09/16/2018,Ron Torbert,8,96,4,43,4,53,9,2,2018
Miami,N.Y. Jets,09/16/2018,Brad Allen,9,60,2,10,7,50,10,2,2018
Kansas City,Pittsburgh,09/16/2018,Jerome Boger,24,166,12,76,12,90,27,2,2018
Philadelphia,Tampa Bay,09/16/2018,Alex Kemp,10,99,6,55,4,44,14,2,2018
Houston,Tennessee,09/16/2018,Pete Morelli,19,158,11,88,8,70,19,2,2018
Indianapolis,Washington,09/16/2018,Clete Blakeman,13,116,6,26,7,90,13,2,2018
Arizona,LA Rams,09/16/2018,Craig Wrolstad,14,96,9,47,5,49,14,2,2018
Detroit,San Francisco,09/16/2018,Shawn Hochuli,19,191,10,105,9,86,23,2,2018
Oakland,Denver,09/16/2018,John Hussey,10,65,4,30,6,35,14,2,2018
New England,Jacksonville,09/16/2018,Carl Cheffers,9,96,2,25,7,71,9,2,2018
N.Y. Giants,Dallas,09/16/2018,John Parry,9,71,3,24,6,47,10,2,2018
Seattle,Chicago,09/17/2018,Walt Coleman,12,92,5,37,7,55,12,2,2018
N.Y. Jets,Cleveland,09/20/2018,Jerome Boger,11,96,6,55,5,41,19,3,2018
New Orleans,Atlanta,09/23/2018,Walt Anderson,16,174,11,120,5,54,18,3,2018
Denver,Baltimore,09/23/2018,Ron Torbert,20,172,13,120,7,52,20,3,2018
Cincinnati,Carolina,09/23/2018,John Parry,7,53,4,36,3,17,8,3,2018
N.Y. Giants,Houston,09/23/2018,Walt Coleman,10,70,3,20,7,50,17,3,2018
Tennessee,Jacksonville,09/23/2018,Shawn Smith,12,105,4,30,8,75,12,3,2018
San Francisco,Kansas City,09/23/2018,Tony Corrente,20,195,14,147,6,48,26,3,2018
Oakland,Miami,09/23/2018,Shawn Hochuli,17,112,8,38,9,74,22,3,2018
Buffalo,Minnesota,09/23/2018,Alex Kemp,18,143,12,84,6,59,19,3,2018
Indianapolis,Philadelphia,09/23/2018,Clay Martin,21,187,11,77,10,110,25,3,2018
Green Bay,Washington,09/23/2018,Craig Wrolstad,17,181,11,115,6,66,19,3,2018
LA Chargers,LA Rams,09/23/2018,John Hussey,10,94,4,30,6,64,10,3,2018
Chicago,Arizona,09/23/2018,Bill Vinovich,13,88,7,45,6,43,15,3,2018
Dallas,Seattle,09/23/2018,Carl Cheffers,17,122,7,55,10,67,18,3,2018
New England,Detroit,09/23/2018,Clete Blakeman,11,108,5,38,6,70,12,3,2018
Pittsburgh,Tampa Bay,09/24/2018,Pete Morelli,22,235,13,155,9,80,26,3,2018
Minnesota,LA Rams,09/27/2018,Brad Allen,6,50,4,35,2,15,10,4,2018
Cincinnati,Atlanta,09/30/2018,Shawn Smith,16,150,6,55,10,95,21,4,2018
Tampa Bay,Chicago,09/30/2018,Jerome Boger,15,137,11,99,4,38,18,4,2018
Detroit,Dallas,09/30/2018,Walt Coleman,10,78,8,58,2,20,13,4,2018
Buffalo,Green Bay,09/30/2018,Bill Vinovich,8,80,3,20,5,60,9,4,2018
Houston,Indianapolis,09/30/2018,Carl Cheffers,20,139,10,54,10,85,23,4,2018
N.Y. Jets,Jacksonville,09/30/2018,Clay Martin,15,132,6,43,9,89,16,4,2018
Miami,New England,09/30/2018,Alex Kemp,16,146,10,89,6,57,19,4,2018
Philadelphia,Tennessee,09/30/2018,Shawn Hochuli,12,107,8,77,4,30,13,4,2018
Seattle,Arizona,09/30/2018,John Hussey,13,95,8,57,5,38,14,4,2018
Cleveland,Oakland,09/30/2018,Walt Anderson,14,120,8,55,6,65,16,4,2018
San Francisco,LA Chargers,09/30/2018,Ron Torbert,9,78,4,29,5,49,9,4,2018
New Orleans,N.Y. Giants,09/30/2018,Pete Morelli,11,118,5,51,6,67,12,4,2018
Baltimore,Pittsburgh,09/30/2018,Tony Corrente,12,90,7,50,5,40,13,4,2018
Kansas City,Denver,10/01/2018,Craig Wrolstad,13,118,10,93,3,25,15,4,2018
Indianapolis,New England,10/04/2018,Shawn Hochuli,11,85,4,35,7,50,15,5,2018
Tennessee,Buffalo,10/07/2018,Tony Corrente,9,70,5,40,4,30,10,5,2018
N.Y. Giants,Carolina,10/07/2018,Jerome Boger,12,84,8,62,4,22,15,5,2018
Miami,Cincinnati,10/07/2018,Craig Wrolstad,15,132,9,85,6,47,18,5,2018
Baltimore,Cleveland,10/07/2018,John Hussey,14,107,4,41,10,66,18,5,2018
Green Bay,Detroit,10/07/2018,Pete Morelli,20,183,12,112,8,71,25,5,2018
Jacksonville,Kansas City,10/07/2018,Brad Allen,16,150,5,45,11,105,18,5,2018
Denver,N.Y. Jets,10/07/2018,Clay Martin,10,78,6,45,4,33,12,5,2018
Atlanta,Pittsburgh,10/07/2018,John Parry,14,133,7,75,7,58,16,5,2018
Oakland,LA Chargers,10/07/2018,Alex Kemp,16,137,7,55,9,82,19,5,2018
Minnesota,Philadelphia,10/07/2018,Walt Coleman,12,75,4,23,8,52,15,5,2018
Arizona,San Francisco,10/07/2018,Shawn Smith,14,111,5,46,9,65,17,5,2018
LA Rams,Seattle,10/07/2018,Clete Blakeman,14,95,7,45,7,50,17,5,2018
Dallas,Houston,10/07/2018,Bill Vinovich,12,97,7,72,5,25,12,5,2018
Washington,New Orleans,10/08/2018,Carl Cheffers,10,83,6,38,4,45,12,5,2018
Philadelphia,N.Y. Giants,10/11/2018,Ron Torbert,9,86,4,25,5,61,13,6,2018
Tampa Bay,Atlanta,10/14/2018,Walt Coleman,9,50,4,20,5,30,13,6,2018
Pittsburgh,Cincinnati,10/14/2018,Clete Blakeman,15,99,9,69,6,30,16,6,2018
LA Chargers,Cleveland,10/14/2018,Brad Allen,16,125,10,72,6,53,20,6,2018
Buffalo,Houston,10/14/2018,Craig Wrolstad,18,154,12,104,6,50,19,6,2018
Chicago,Miami,10/14/2018,Walt Anderson,13,125,6,58,7,67,15,6,2018
Arizona,Minnesota,10/14/2018,Jerome Boger,14,82,5,30,9,52,17,6,2018
Indianapolis,N.Y. Jets,10/14/2018,Alex Kemp,15,115,8,66,7,49,16,6,2018
Seattle,Oakland,10/14/2018,Pete Morelli,13,102,8,64,5,38,13,6,2018
Carolina,Washington,10/14/2018,Clay Martin,13,98,8,55,5,43,13,6,2018
LA Rams,Denver,10/14/2018,Shawn Smith,16,142,10,81,6,61,16,6,2018
Jacksonville,Dallas,10/14/2018,Tony Corrente,7,55,4,30,3,25,7,6,2018
Baltimore,Tennessee,10/14/2018,Carl Cheffers,14,105,10,70,4,35,16,6,2018
Kansas City,New England,10/14/2018,John Hussey,5,58,5,58,0,0,10,6,2018
San Francisco,Green Bay,10/15/2018,John Parry,8,64,2,10,6,54,13,6,2018
Denver,Arizona,10/18/2018,Alex Kemp,12,95,5,50,7,45,13,7,2018
Tennessee,LA Chargers,10/21/2018,Walt Coleman,8,63,4,32,4,31,9,7,2018
New Orleans,Baltimore,10/21/2018,John Parry,11,106,6,52,5,54,12,7,2018
New England,Chicago,10/21/2018,Clay Martin,12,104,7,64,5,40,15,7,2018
Buffalo,Indianapolis,10/21/2018,Brad Allen,11,94,7,59,4,35,12,7,2018
Houston,Jacksonville,10/21/2018,Ron Torbert,8,50,6,35,2,15,8,7,2018
Cincinnati,Kansas City,10/21/2018,Bill Vinovich,16,108,8,58,8,50,16,7,2018
Detroit,Miami,10/21/2018,Jerome Boger,10,93,6,43,4,50,12,7,2018
Minnesota,N.Y. Jets,10/21/2018,Shawn Smith,14,126,6,55,8,71,15,7,2018
Carolina,Philadelphia,10/21/2018,Clete Blakeman,9,113,5,78,4,35,12,7,2018
Cleveland,Tampa Bay,10/21/2018,Shawn Hochuli,22,179,14,114,8,65,24,7,2018
Dallas,Washington,10/21/2018,John Hussey,13,100,8,65,5,35,14,7,2018
LA Rams,San Francisco,10/21/2018,Walt Anderson,3,20,1,10,2,10,6,7,2018
N.Y. Giants,Atlanta,10/22/2018,Tony Corrente,9,87,4,58,5,29,11,7,2018
Miami,Houston,10/25/2018,Shawn Smith,13,120,5,63,8,57,20,8,2018
Philadelphia,Jacksonville,10/28/2018,John Hussey,9,81,4,36,5,45,11,8,2018
Baltimore,Carolina,10/28/2018,Pete Morelli,13,98,9,68,4,30,13,8,2018
N.Y. Jets,Chicago,10/28/2018,Clete Blakeman,10,70,8,45,2,25,15,8,2018
Tampa Bay,Cincinnati,10/28/2018,Alex Kemp,15,121,11,75,4,46,22,8,2018
Seattle,Detroit,10/28/2018,Walt Anderson,11,143,7,111,4,32,12,8,2018
Denver,Kansas City,10/28/2018,Shawn Hochuli,17,133,10,83,7,50,26,8,2018
Washington,N.Y. Giants,10/28/2018,Bill Vinovich,19,192,8,90,11,102,24,8,2018
Cleveland,Pittsburgh,10/28/2018,Carl Cheffers,15,112,7,52,8,60,17,8,2018
Indianapolis,Oakland,10/28/2018,John Parry,20,156,10,77,10,79,25,8,2018
San Francisco,Arizona,10/28/2018,Brad Allen,14,121,5,59,9,62,16,8,2018
Green Bay,LA Rams,10/28/2018,Ron Torbert,4,25,2,10,2,15,5,8,2018
New Orleans,Minnesota,10/28/2018,Craig Wrolstad,13,118,7,64,6,54,14,8,2018
New England,Buffalo,10/29/2018,Jerome Boger,11,84,5,33,6,51,16,8,2018
Oakland,San Francisco,11/01/2018,Carl Cheffers,9,63,6,40,3,23,11,9,2018
Pittsburgh,Baltimore,11/04/2018,Craig Wrolstad,13,128,8,103,5,25,18,9,2018
Chicago,Buffalo,11/04/2018,Shawn Smith,24,292,14,129,10,163,25,9,2018
Tampa Bay,Carolina,11/04/2018,Tony Corrente,17,133,8,49,9,84,18,9,2018
Kansas City,Cleveland,11/04/2018,Ron Torbert,15,106,11,86,4,20,20,9,2018
N.Y. Jets,Miami,11/04/2018,Walt Coleman,10,100,5,45,5,55,10,9,2018
Detroit,Minnesota,11/04/2018,Pete Morelli,11,81,8,66,3,15,13,9,2018
Atlanta,Washington,11/04/2018,Walt Anderson,17,197,7,50,10,147,20,9,2018
Houston,Denver,11/04/2018,Clay Martin,15,110,7,60,8,50,16,9,2018
LA Chargers,Seattle,11/04/2018,Shawn Hochuli,22,188,12,105,10,83,26,9,2018
LA Rams,New Orleans,11/04/2018,Bill Vinovich,6,52,4,32,2,20,7,9,2018
Green Bay,New England,11/04/2018,Brad Allen,12,93,7,63,5,30,16,9,2018
Tennessee,Dallas,11/05/2018,Clete Blakeman,9,72,3,20,6,52,11,9,2018
Carolina,Pittsburgh,11/08/2018,Walt Coleman,6,66,5,42,1,24,7,10,2018
Detroit,Chicago,11/11/2018,Alex Kemp,12,87,6,41,6,46,15,10,2018
New Orleans,Cincinnati,11/11/2018,Tony Corrente,5,31,1,5,4,26,6,10,2018
Atlanta,Cleveland,11/11/2018,Pete Morelli,8,43,1,5,7,38,10,10,2018
Miami,Green Bay,11/11/2018,Clay Martin,9,55,3,10,6,45,14,10,2018
Jacksonville,Indianapolis,11/11/2018,Jerome Boger,15,106,8,61,7,45,18,10,2018
Arizona,Kansas City,11/11/2018,Carl Cheffers,11,93,3,30,8,63,15,10,2018
Buffalo,N.Y. Jets,11/11/2018,Ron Torbert,5,40,4,30,1,10,7,10,2018
Washington,Tampa Bay,11/11/2018,Brad Allen,13,102,8,52,5,50,14,10,2018
New England,Tennessee,11/11/2018,Bill Vinovich,8,66,4,31,4,35,10,10,2018
LA Chargers,Oakland,11/11/2018,Craig Wrolstad,12,125,6,70,6,55,13,10,2018
Seattle,LA Rams,11/11/2018,John Hussey,17,158,7,56,10,102,20,10,2018
Dallas,Philadelphia,11/11/2018,John Parry,5,37,5,37,0,0,5,10,2018
N.Y. Giants,San Francisco,11/12/2018,Shawn Hochuli,18,175,8,78,10,97,20,10,2018
Green Bay,Seattle,11/15/2018,Tony Corrente,11,110,5,80,6,30,12,11,2018
Dallas,Atlanta,11/18/2018,Craig Wrolstad,4,35,2,20,2,15,5,11,2018
Cincinnati,Baltimore,11/18/2018,Walt Coleman,12,89,7,58,5,31,12,11,2018
Minnesota,Chicago,11/18/2018,John Parry,9,96,4,50,5,46,11,11,2018
Carolina,Detroit,11/18/2018,Clay Martin,3,20,2,15,1,5,7,11,2018
Tennessee,Indianapolis,11/18/2018,John Hussey,15,172,8,112,7,60,16,11,2018
Tampa Bay,N.Y. Giants,11/18/2018,Shawn Smith,12,100,4,40,8,60,12,11,2018
Houston,Washington,11/18/2018,Alex Kemp,13,83,7,40,6,43,14,11,2018
Oakland,Arizona,11/18/2018,Jerome Boger,11,82,4,20,7,62,12,11,2018
Denver,LA Chargers,11/18/2018,Pete Morelli,21,163,7,43,14,120,23,11,2018
Philadelphia,New Orleans,11/18/2018,Carl Cheffers,14,118,6,49,8,69,16,11,2018
Pittsburgh,Jacksonville,11/18/2018,Walt Anderson,14,126,3,15,11,111,17,11,2018
Kansas City,LA Rams,11/19/2018,Clete Blakeman,21,195,14,145,7,50,26,11,2018
Chicago,Detroit,11/22/2018,Brad Allen,8,74,3,20,5,54,8,12,2018
Washington,Dallas,11/22/2018,Ron Torbert,8,55,4,25,4,30,10,12,2018
Atlanta,New Orleans,11/22/2018,John Hussey,5,45,2,26,3,19,8,12,2018
Oakland,Baltimore,11/25/2018,Clay Martin,10,69,4,24,6,45,14,12,2018
Jacksonville,Buffalo,11/25/2018,Walt Coleman,23,170,10,90,13,80,30,12,2018
Seattle,Carolina,11/25/2018,Shawn Smith,7,66,4,36,3,30,9,12,2018
Cleveland,Cincinnati,11/25/2018,Jerome Boger,20,157,7,61,13,96,23,12,2018
Miami,Indianapolis,11/25/2018,Clete Blakeman,17,127,10,75,7,52,23,12,2018
New England,N.Y. Jets,11/25/2018,Shawn Hochuli,19,152,11,105,8,47,20,12,2018
N.Y. Giants,Philadelphia,11/25/2018,Walt Anderson,18,137,11,91,7,46,19,12,2018
San Francisco,Tampa Bay,11/25/2018,John Parry,17,138,8,68,9,70,20,12,2018
Arizona,LA Chargers,11/25/2018,Alex Kemp,7,65,3,35,4,30,11,12,2018
Pittsburgh,Denver,11/25/2018,Tony Corrente,11,84,5,34,6,50,16,12,2018
Green Bay,Minnesota,11/25/2018,Bill Vinovich,10,75,4,20,6,55,11,12,2018
Tennessee,Houston,11/26/2018,Craig Wrolstad,10,103,7,50,3,53,12,12,2018
New Orleans,Dallas,11/29/2018,Walt Anderson,13,128,5,48,8,80,17,13,2018
Baltimore,Atlanta,12/02/2018,Brad Allen,17,170,9,88,8,82,20,13,2018
Denver,Cincinnati,12/02/2018,Ron Torbert,19,160,7,60,12,100,22,13,2018
LA Rams,Detroit,12/02/2018,John Parry,15,159,7,105,8,54,22,13,2018
Arizona,Green Bay,12/02/2018,Pete Morelli,14,92,7,49,7,43,17,13,2018
Cleveland,Houston,12/02/2018,Walt Coleman,11,122,6,45,5,77,13,13,2018
Indianapolis,Jacksonville,12/02/2018,Alex Kemp,14,139,6,65,8,74,17,13,2018
Buffalo,Miami,12/02/2018,Shawn Hochuli,21,209,13,120,8,89,28,13,2018
Chicago,N.Y. Giants,12/02/2018,Clay Martin,20,165,8,58,12,107,23,13,2018
LA Chargers,Pittsburgh,12/02/2018,Bill Vinovich,12,139,5,80,7,59,14,13,2018
Carolina,Tampa Bay,12/02/2018,Carl Cheffers,16,173,7,104,9,69,17,13,2018
Kansas City,Oakland,12/02/2018,Shawn Smith,19,168,11,94,8,74,25,13,2018
N.Y. Jets,Tennessee,12/02/2018,Jerome Boger,19,171,11,96,8,75,23,13,2018
Minnesota,New England,12/02/2018,Craig Wrolstad,12,115,5,55,7,60,12,13,2018
San Francisco,Seattle,12/02/2018,Clete Blakeman,23,228,14,133,9,95,26,13,2018
Washington,Philadelphia,12/03/2018,Tony Corrente,15,107,10,69,5,38,18,13,2018
Jacksonville,Tennessee,12/06/2018,John Parry,10,97,7,67,3,30,13,14,2018
N.Y. Jets,Buffalo,12/09/2018,Alex Kemp,14,140,7,93,7,47,16,14,2018
LA Rams,Chicago,12/09/2018,Craig Wrolstad,15,102,9,57,6,45,15,14,2018
Carolina,Cleveland,12/09/2018,Walt Anderson,17,120,10,68,7,52,22,14,2018
Atlanta,Green Bay,12/09/2018,Walt Coleman,19,138,13,101,6,37,22,14,2018
Indianapolis,Houston,12/09/2018,Bill Vinovich,16,94,9,59,7,35,19,14,2018
Baltimore,Kansas City,12/09/2018,Tony Corrente,18,165,11,112,7,53,22,14,2018
New England,Miami,12/09/2018,Pete Morelli,12,111,5,30,7,81,15,14,2018
New Orleans,Tampa Bay,12/09/2018,Jerome Boger,16,135,6,51,10,84,20,14,2018
N.Y. Giants,Washington,12/09/2018,Carl Cheffers,17,153,2,18,15,135,20,14,2018
Cincinnati,LA Chargers,12/09/2018,John Hussey,12,72,6,34,6,38,13,14,2018
Denver,San Francisco,12/09/2018,Shawn Smith,22,149,11,62,11,87,24,14,2018
Detroit,Arizona,12/09/2018,Shawn Hochuli,15,151,7,68,8,83,22,14,2018
Philadelphia,Dallas,12/09/2018,Clete Blakeman,16,160,5,49,11,111,19,14,2018
Pittsburgh,Oakland,12/09/2018,Ron Torbert,15,144,2,14,13,130,15,14,2018
Minnesota,Seattle,12/10/2018,Brad Allen,8,96,4,51,4,45,10,14,2018
LA Chargers,Kansas City,12/13/2018,Walt Anderson,17,116,7,50,10,66,21,15,2018
Houston,N.Y. Jets,12/15/2018,Brad Allen,14,103,5,43,9,60,16,15,2018
Cleveland,Denver,12/15/2018,Clay Martin,14,126,6,75,8,51,20,15,2018
Arizona,Atlanta,12/16/2018,Shawn Smith,14,125,8,75,6,50,18,15,2018
Tampa Bay,Baltimore,12/16/2018,Ron Torbert,14,128,6,58,8,70,14,15,2018
Detroit,Buffalo,12/16/2018,Jerome Boger,7,101,4,81,3,20,14,15,2018
Green Bay,Chicago,12/16/2018,John Hussey,11,72,7,48,4,24,12,15,2018
Oakland,Cincinnati,12/16/2018,Alex Kemp,17,175,8,90,9,85,19,15,2018
Dallas,Indianapolis,12/16/2018,Carl Cheffers,15,129,9,74,6,55,17,15,2018
Washington,Jacksonville,12/16/2018,Clete Blakeman,14,103,6,48,8,55,19,15,2018
Miami,Minnesota,12/16/2018,Walt Coleman,14,94,8,49,6,45,15,15,2018
Tennessee,N.Y. Giants,12/16/2018,Shawn Hochuli,14,93,4,35,10,58,17,15,2018
Seattle,San Francisco,12/16/2018,Pete Morelli,22,214,14,148,8,66,23,15,2018
New England,Pittsburgh,12/16/2018,John Parry,18,146,14,106,4,40,19,15,2018
Philadelphia,LA Rams,12/16/2018,Bill Vinovich,11,99,6,49,5,50,13,15,2018
New Orleans,Carolina,12/17/2018,Tony Corrente,13,128,9,80,4,48,18,15,2018
Washington,Tennessee,12/22/2018,John Hussey,10,59,8,49,2,10,11,16,2018
Baltimore,LA Chargers,12/22/2018,Clete Blakeman,12,109,4,40,8,69,13,16,2018
N.Y. Giants,Indianapolis,12/23/2018,Brad Allen,12,53,6,24,6,29,15,16,2018
Jacksonville,Miami,12/23/2018,Clay Martin,20,192,10,97,10,95,25,16,2018
Atlanta,Carolina,12/23/2018,Pete Morelli,14,127,4,41,10,86,15,16,2018
Cincinnati,Cleveland,12/23/2018,Tony Corrente,9,72,3,15,6,57,10,16,2018
Tampa Bay,Dallas,12/23/2018,Shawn Hochuli,19,139,9,72,10,67,19,16,2018
Minnesota,Detroit,12/23/2018,Walt Anderson,18,133,11,78,7,55,21,16,2018
Buffalo,New England,12/23/2018,Shawn Smith,8,78,3,29,5,49,8,16,2018
Green Bay,N.Y. Jets,12/23/2018,Ron Torbert,26,258,10,86,16,172,29,16,2018
Houston,Philadelphia,12/23/2018,John Parry,21,166,10,61,11,105,21,16,2018
LA Rams,Arizona,12/23/2018,Walt Coleman,13,120,6,66,7,54,15,16,2018
Chicago,San Francisco,12/23/2018,Alex Kemp,10,75,4,30,6,45,18,16,2018
Pittsburgh,New Orleans,12/23/2018,Craig Wrolstad,15,170,6,79,9,91,17,16,2018
Kansas City,Seattle,12/23/2018,Bill Vinovich,11,96,8,76,3,20,13,16,2018
Denver,Oakland,12/24/2018,Carl Cheffers,17,141,11,91,6,50,18,16,2018
Cleveland,Baltimore,12/30/2018,Shawn Smith,14,100,4,35,10,65,14,17,2018
Miami,Buffalo,12/30/2018,John Hussey,7,59,4,35,3,24,13,17,2018
Detroit,Green Bay,12/30/2018,Alex Kemp,8,72,3,34,5,38,8,17,2018
Jacksonville,Houston,12/30/2018,Pete Morelli,10,83,8,68,2,15,10,17,2018
Oakland,Kansas City,12/30/2018,Shawn Hochuli,8,72,4,22,4,50,8,17,2018
Chicago,Minnesota,12/30/2018,Clete Blakeman,14,132,11,102,3,30,16,17,2018
N.Y. Jets,New England,12/30/2018,Walt Coleman,8,60,4,30,4,30,9,17,2018
Carolina,New Orleans,12/30/2018,Bill Vinovich,8,104,2,10,6,94,8,17,2018
Dallas,N.Y. Giants,12/30/2018,Clay Martin,17,124,6,46,11,78,17,17,2018
Cincinnati,Pittsburgh,12/30/2018,Carl Cheffers,18,155,9,85,9,70,19,17,2018
Atlanta,Tampa Bay,12/30/2018,Brad Allen,12,115,9,85,3,30,13,17,2018
Indianapolis,Tennessee,12/30/2018,Walt Anderson,21,171,12,96,9,75,24,17,2018
Philadelphia,Washington,12/30/2018,Craig Wrolstad,7,40,5,25,2,15,8,17,2018
LA Chargers,Denver,12/30/2018,John Parry,17,150,6,51,11,99,22,17,2018
San Francisco,LA Rams,12/30/2018,Jerome Boger,11,98,5,41,6,57,14,17,2018
Arizona,Seattle,12/30/2018,Ron Torbert,4,30,3,20,1,10,4,17,2018
Green Bay,Chicago,09/05/2019,Tony Corrente,20,178,10,71,10,107,24,1,2019
LA Rams,Carolina,09/08/2019,Shawn Hochuli,11,89,5,43,6,46,16,1,2019
Tennessee,Cleveland,09/08/2019,Brad Allen,24,236,6,54,18,182,28,1,2019
Kansas City,Jacksonville,09/08/2019,Carl Cheffers,15,126,5,55,10,71,25,1,2019
Baltimore,Miami,09/08/2019,Jerome Boger,13,104,4,40,9,64,16,1,2019
Atlanta,Minnesota,09/08/2019,Bill Vinovich,20,178,9,78,11,100,23,1,2019
Buffalo,N.Y. Jets,09/08/2019,Clay Martin,15,122,7,55,8,67,18,1,2019
Washington,Philadelphia,09/08/2019,Ron Torbert,18,151,12,96,6,55,20,1,2019
Indianapolis,LA Chargers,09/08/2019,Shawn Smith,6,30,3,10,3,20,6,1,2019
Cincinnati,Seattle,09/08/2019,Brad Rogers,15,112,7,57,8,55,19,1,2019
Detroit,Arizona,09/08/2019,Scott Novak,16,94,9,59,7,35,23,1,2019
N.Y. Giants,Dallas,09/08/2019,Walt Anderson,14,117,8,70,6,47,16,1,2019
San Francisco,Tampa Bay,09/08/2019,Alex Kemp,19,174,11,87,8,87,23,1,2019
Pittsburgh,New England,09/08/2019,Clete Blakeman,13,109,6,54,7,55,14,1,2019
Houston,New Orleans,09/09/2019,John Hussey,15,117,8,69,7,48,18,1,2019
Denver,Oakland,09/09/2019,Craig Wrolstad,15,106,6,44,9,62,17,1,2019
Tampa Bay,Carolina,09/12/2019,Jerome Boger,17,116,12,66,5,50,19,2,2019
Arizona,Baltimore,09/15/2019,Ron Torbert,18,132,8,70,10,62,20,2,2019
San Francisco,Cincinnati,09/15/2019,Tony Corrente,16,135,9,75,7,60,20,2,2019
LA Chargers,Detroit,09/15/2019,Craig Wrolstad,17,141,9,70,8,71,24,2,2019
Minnesota,Green Bay,09/15/2019,John Hussey,14,135,8,100,6,35,20,2,2019
Jacksonville,Houston,09/15/2019,Scott Novak,16,117,9,70,7,47,17,2,2019
New England,Miami,09/15/2019,Bill Vinovich,9,76,5,54,4,22,14,2,2019
Buffalo,N.Y. Giants,09/15/2019,Shawn Smith,16,105,9,65,7,40,18,2,2019
Seattle,Pittsburgh,09/15/2019,Carl Cheffers,15,171,10,93,5,78,20,2,2019
Indianapolis,Tennessee,09/15/2019,Clete Blakeman,13,140,8,65,5,75,16,2,2019
Dallas,Washington,09/15/2019,Shawn Hochuli,14,111,8,67,6,44,18,2,2019
Kansas City,Oakland,09/15/2019,Clay Martin,17,166,10,114,7,52,21,2,2019
Chicago,Denver,09/15/2019,Adrian Hill,17,150,7,69,10,81,20,2,2019
New Orleans,LA Rams,09/15/2019,Walt Anderson,19,152,11,87,8,65,22,2,2019
Philadelphia,Atlanta,09/15/2019,Brad Allen,17,118,7,60,10,58,20,2,2019
Cleveland,N.Y. Jets,09/16/2019,Alex Kemp,21,174,9,85,12,89,27,2,2019
Tennessee,Jacksonville,09/19/2019,Shawn Hochuli,13,131,9,101,4,30,20,3,2019
Cincinnati,Buffalo,09/22/2019,Clete Blakeman,15,109,8,54,7,55,16,3,2019
Miami,Dallas,09/22/2019,Adrian Hill,13,135,5,35,8,100,17,3,2019
Denver,Green Bay,09/22/2019,Brad Rogers,10,80,3,27,7,53,13,3,2019
Atlanta,Indianapolis,09/22/2019,Alex Kemp,20,167,16,128,4,39,22,3,2019
Baltimore,Kansas City,09/22/2019,John Hussey,11,91,7,60,4,31,13,3,2019
Oakland,Minnesota,09/22/2019,Jerome Boger,13,143,7,84,6,59,14,3,2019
N.Y. Jets,New England,09/22/2019,Carl Cheffers,13,137,5,67,8,70,15,3,2019
Detroit,Philadelphia,09/22/2019,Tony Corrente,13,91,9,61,4,30,14,3,2019
Carolina,Arizona,09/22/2019,Craig Wrolstad,10,87,3,35,7,52,15,3,2019
N.Y. Giants,Tampa Bay,09/22/2019,Bill Vinovich,10,89,6,59,4,30,13,3,2019
Houston,LA Chargers,09/22/2019,Clay Martin,13,134,6,65,7,69,18,3,2019
New Orleans,Seattle,09/22/2019,Ron Torbert,18,123,11,70,7,53,19,3,2019
Pittsburgh,San Francisco,09/22/2019,Scott Novak,11,113,6,42,5,71,13,3,2019
LA Rams,Cleveland,09/22/2019,Shawn Smith,15,110,7,50,8,60,20,3,2019
Chicago,Washington,09/23/2019,Walt Anderson,18,120,9,59,9,61,23,3,2019
Philadelphia,Green Bay,09/26/2019,Clay Martin,14,143,9,93,5,50,15,4,2019
Tennessee,Atlanta,09/29/2019,John Hussey,12,127,5,77,7,50,15,4,2019
Cleveland,Baltimore,09/29/2019,Shawn Hochuli,9,56,6,41,3,15,15,4,2019
New England,Buffalo,09/29/2019,Craig Wrolstad,16,134,8,58,8,76,23,4,2019
Kansas City,Detroit,09/29/2019,Walt Anderson,15,99,7,51,8,48,19,4,2019
Carolina,Houston,09/29/2019,Adrian Hill,13,116,6,35,7,81,16,4,2019
Oakland,Indianapolis,09/29/2019,Scott Novak,16,115,11,80,5,35,22,4,2019
LA Chargers,Miami,09/29/2019,Tony Corrente,15,142,10,89,5,53,18,4,2019
Washington,N.Y. Giants,09/29/2019,Alex Kemp,17,103,12,58,5,45,22,4,2019
Seattle,Arizona,09/29/2019,Shawn Smith,14,109,7,65,7,44,16,4,2019
Tampa Bay,LA Rams,09/29/2019,Brad Rogers,25,205,12,99,13,106,28,4,2019
Minnesota,Chicago,09/29/2019,Brad Allen,14,118,7,68,7,50,17,4,2019
Jacksonville,Denver,09/29/2019,Ron Torbert,17,152,12,104,5,48,21,4,2019
Dallas,New Orleans,09/29/2019,Carl Cheffers,15,144,6,64,9,80,17,4,2019
Cincinnati,Pittsburgh,09/30/2019,Bill Vinovich,12,97,8,60,4,37,13,4,2019
LA Rams,Seattle,10/03/2019,Scott Novak,11,90,6,45,5,45,17,5,2019
Jacksonville,Carolina,10/06/2019,Alex Kemp,17,154,9,84,8,70,21,5,2019
Arizona,Cincinnati,10/06/2019,John Hussey,19,156,12,96,7,60,23,5,2019
Atlanta,Houston,10/06/2019,Shawn Smith,16,152,7,63,9,89,17,5,2019
Tampa Bay,New Orleans,10/06/2019,Brad Allen,10,70,4,30,6,40,13,5,2019
Minnesota,N.Y. Giants,10/06/2019,Clete Blakeman,17,157,12,112,5,45,22,5,2019
Chicago,Oakland,10/06/2019,Tony Corrente,16,144,10,75,6,69,21,5,2019
N.Y. Jets,Philadelphia,10/06/2019,Adrian Hill,18,128,9,52,9,76,20,5,2019
Baltimore,Pittsburgh,10/06/2019,Walt Anderson,22,168,11,92,11,76,25,5,2019
Buffalo,Tennessee,10/06/2019,Brad Rogers,19,138,11,78,8,60,20,5,2019
New England,Washington,10/06/2019,Clay Martin,13,127,7,55,6,72,16,5,2019
Denver,LA Chargers,10/06/2019,Shawn Hochuli,16,165,12,122,4,43,18,5,2019
Green Bay,Dallas,10/06/2019,Ron Torbert,20,202,9,78,11,124,24,5,2019
Indianapolis,Kansas City,10/06/2019,Craig Wrolstad,18,175,7,50,11,125,23,5,2019
Cleveland,San Francisco,10/07/2019,Jerome Boger,11,89,7,55,4,34,12,5,2019
N.Y. Giants,New England,10/10/2019,Brad Allen,8,60,5,40,3,20,10,6,2019
Carolina,Tampa Bay,10/13/2019,Walt Anderson,12,100,3,30,9,70,14,6,2019
Cincinnati,Baltimore,10/13/2019,Clay Martin,14,101,4,20,10,81,17,6,2019
Seattle,Cleveland,10/13/2019,Adrian Hill,19,148,10,65,9,83,20,6,2019
New Orleans,Jacksonville,10/13/2019,Jerome Boger,5,50,3,35,2,15,11,6,2019
Houston,Kansas City,10/13/2019,Shawn Hochuli,21,149,10,70,11,79,29,6,2019
Washington,Miami,10/13/2019,Shawn Smith,11,101,6,56,5,45,12,6,2019
Philadelphia,Minnesota,10/13/2019,Scott Novak,11,79,7,49,4,30,12,6,2019
Atlanta,Arizona,10/13/2019,Carl Cheffers,16,129,8,72,8,57,20,6,2019
San Francisco,LA Rams,10/13/2019,Bill Vinovich,12,89,4,30,8,59,14,6,2019
Tennessee,Denver,10/13/2019,Alex Kemp,14,91,6,40,8,51,17,6,2019
Dallas,N.Y. Jets,10/13/2019,Brad Rogers,17,173,9,68,8,105,21,6,2019
Pittsburgh,LA Chargers,10/13/2019,John Hussey,14,119,6,45,8,74,15,6,2019
Detroit,Green Bay,10/14/2019,Clete Blakeman,14,98,8,50,6,48,14,6,2019
Kansas City,Denver,10/17/2019,Shawn Smith,10,79,6,46,4,33,12,7,2019
LA Rams,Atlanta,10/20/2019,Ron Torbert,10,72,5,24,5,48,13,7,2019
Miami,Buffalo,10/20/2019,Carl Cheffers,15,138,6,55,9,83,17,7,2019
Jacksonville,Cincinnati,10/20/2019,Craig Wrolstad,17,180,11,130,6,50,21,7,2019
Minnesota,Detroit,10/20/2019,Brad Rogers,14,128,6,61,8,67,19,7,2019
Oakland,Green Bay,10/20/2019,Alex Kemp,11,117,8,97,3,20,12,7,2019
Houston,Indianapolis,10/20/2019,Tony Corrente,16,99,10,54,6,45,21,7,2019
Arizona,N.Y. Giants,10/20/2019,Adrian Hill,16,160,10,85,6,75,19,7,2019
San Francisco,Washington,10/20/2019,Clete Blakeman,9,67,2,20,7,47,10,7,2019
LA Chargers,Tennessee,10/20/2019,Bill Vinovich,11,83,4,29,7,54,13,7,2019
New Orleans,Chicago,10/20/2019,Scott Novak,7,45,4,35,3,10,11,7,2019
Baltimore,Seattle,10/20/2019,Brad Allen,10,93,8,75,2,18,14,7,2019
Philadelphia,Dallas,10/20/2019,Jerome Boger,11,105,5,40,6,65,16,7,2019
New England,N.Y. Jets,10/21/2019,Shawn Hochuli,15,152,7,92,8,60,17,7,2019
Washington,Minnesota,10/24/2019,Carl Cheffers,11,120,4,46,7,74,16,8,2019
Seattle,Atlanta,10/27/2019,Clete Blakeman,14,100,9,60,5,40,19,8,2019
Philadelphia,Buffalo,10/27/2019,John Hussey,12,101,4,44,8,57,16,8,2019
LA Chargers,Chicago,10/27/2019,Brad Rogers,13,95,8,53,5,42,16,8,2019
N.Y. Giants,Detroit,10/27/2019,Scott Novak,12,119,5,44,7,75,13,8,2019
Oakland,Houston,10/27/2019,Craig Wrolstad,18,150,11,100,7,50,19,8,2019
N.Y. Jets,Jacksonville,10/27/2019,Brad Allen,19,153,10,83,9,70,20,8,2019
Cincinnati,LA Rams,10/27/2019,Jerome Boger,15,99,6,40,9,59,18,8,2019
Arizona,New Orleans,10/27/2019,Clay Martin,7,50,5,35,2,15,8,8,2019
Tampa Bay,Tennessee,10/27/2019,Adrian Hill,15,164,9,87,6,77,17,8,2019
Carolina,San Francisco,10/27/2019,Shawn Smith,13,101,9,70,4,31,16,8,2019
Denver,Indianapolis,10/27/2019,Walt Anderson,20,191,10,88,10,103,23,8,2019
Cleveland,New England,10/27/2019,Tony Corrente,17,117,13,85,4,32,19,8,2019
Green Bay,Kansas City,10/27/2019,Bill Vinovich,7,55,4,25,3,30,8,8,2019
Miami,Pittsburgh,10/28/2019,Ron Torbert,14,115,5,45,9,70,18,8,2019
San Francisco,Arizona,10/31/2019,Brad Rogers,17,140,8,75,9,65,19,9,2019
Houston,Jacksonville,11/03/2019,Clete Blakeman,11,94,7,60,4,34,13,9,2019
Washington,Buffalo,11/03/2019,Tony Corrente,5,35,3,15,2,20,9,9,2019
Tennessee,Carolina,11/03/2019,Ron Torbert,17,176,11,99,6,77,22,9,2019
Minnesota,Kansas City,11/03/2019,Alex Kemp,7,50,3,25,4,25,10,9,2019
N.Y. Jets,Miami,11/03/2019,Walt Anderson,16,156,10,105,6,51,19,9,2019
Chicago,Philadelphia,11/03/2019,Craig Wrolstad,17,145,9,70,8,75,19,9,2019
Indianapolis,Pittsburgh,11/03/2019,Brad Allen,12,159,7,89,5,70,14,9,2019
Detroit,Oakland,11/03/2019,Shawn Hochuli,15,131,5,35,10,96,19,9,2019
Tampa Bay,Seattle,11/03/2019,John Hussey,15,127,11,82,4,45,15,9,2019
Cleveland,Denver,11/03/2019,Bill Vinovich,12,95,5,40,7,55,14,9,2019
Green Bay,LA Chargers,11/03/2019,Adrian Hill,13,90,8,45,5,45,15,9,2019
New England,Baltimore,11/03/2019,Carl Cheffers,11,82,7,48,4,34,12,9,2019
Dallas,N.Y. Giants,11/04/2019,Clay Martin,18,175,10,104,8,71,22,9,2019
LA Chargers,Oakland,11/07/2019,Walt Anderson,20,167,8,70,12,97,27,10,2019
Detroit,Chicago,11/10/2019,Carl Cheffers,15,133,8,76,7,57,20,10,2019
Baltimore,Cincinnati,11/10/2019,Scott Novak,6,40,5,35,1,5,8,10,2019
Buffalo,Cleveland,11/10/2019,Ron Torbert,11,110,7,40,4,70,13,10,2019
Carolina,Green Bay,11/10/2019,Jerome Boger,15,110,5,46,10,64,21,10,2019
Atlanta,New Orleans,11/10/2019,Brad Allen,19,138,7,48,12,90,21,10,2019
N.Y. Giants,N.Y. Jets,11/10/2019,John Hussey,13,116,6,62,7,54,13,10,2019
Arizona,Tampa Bay,11/10/2019,Craig Wrolstad,20,181,11,87,9,94,21,10,2019
Kansas City,Tennessee,11/10/2019,Tony Corrente,17,144,9,80,8,64,19,10,2019
Miami,Indianapolis,11/10/2019,Clay Martin,7,55,4,30,3,25,11,10,2019
LA Rams,Pittsburgh,11/10/2019,Shawn Smith,23,197,10,95,13,102,27,10,2019
Minnesota,Dallas,11/10/2019,Shawn Hochuli,10,74,5,35,5,39,13,10,2019
Seattle,San Francisco,11/11/2019,Alex Kemp,14,115,9,75,5,40,14,10,2019
Pittsburgh,Cleveland,11/14/2019,Clete Blakeman,14,162,6,41,8,121,23,11,2019
Houston,Baltimore,11/17/2019,Alex Kemp,13,125,5,60,8,65,18,11,2019
Atlanta,Carolina,11/17/2019,Adrian Hill,11,88,3,20,8,68,15,11,2019
Dallas,Detroit,11/17/2019,Tony Corrente,17,134,6,45,11,89,21,11,2019
Jacksonville,Indianapolis,11/17/2019,Shawn Hochuli,11,101,8,81,3,20,13,11,2019
Buffalo,Miami,11/17/2019,Scott Novak,11,94,5,50,6,44,16,11,2019
Denver,Minnesota,11/17/2019,Clay Martin,11,84,6,35,5,49,16,11,2019
New Orleans,Tampa Bay,11/17/2019,Brad Rogers,16,131,9,76,7,55,18,11,2019
N.Y. Jets,Washington,11/17/2019,Jerome Boger,17,121,6,55,11,66,19,11,2019
Arizona,San Francisco,11/17/2019,Walt Anderson,20,231,10,104,10,127,21,11,2019
Cincinnati,Oakland,11/17/2019,Shawn Smith,11,82,4,40,7,42,15,11,2019
New England,Philadelphia,11/17/2019,Bill Vinovich,13,128,6,89,7,39,14,11,2019
Chicago,LA Rams,11/17/2019,John Hussey,8,59,2,25,6,34,12,11,2019
Kansas City,LA Chargers,11/18/2019,Brad Allen,17,162,8,102,9,60,17,11,2019
Indianapolis,Houston,11/21/2019,Ron Torbert,7,56,3,29,4,27,11,12,2019
Tampa Bay,Atlanta,11/24/2019,Clay Martin,15,111,8,51,7,60,18,12,2019
Denver,Buffalo,11/24/2019,Jerome Boger,19,160,7,70,12,90,19,12,2019
N.Y. Giants,Chicago,11/24/2019,Shawn Hochuli,12,88,6,35,6,53,17,12,2019
Pittsburgh,Cincinnati,11/24/2019,Adrian Hill,17,155,10,76,7,79,18,12,2019
Miami,Cleveland,11/24/2019,Brad Rogers,15,164,8,94,7,70,20,12,2019
Carolina,New Orleans,11/24/2019,Alex Kemp,15,148,3,25,12,123,22,12,2019
Oakland,N.Y. Jets,11/24/2019,Clete Blakeman,8,72,4,35,4,37,8,12,2019
Detroit,Washington,11/24/2019,Bill Vinovich,14,128,6,65,8,63,15,12,2019
Jacksonville,Tennessee,11/24/2019,Shawn Smith,17,158,11,104,6,54,18,12,2019
Dallas,New England,11/24/2019,Scott Novak,13,106,7,50,6,56,14,12,2019
Green Bay,San Francisco,11/24/2019,Carl Cheffers,14,128,5,50,9,78,16,12,2019
Seattle,Philadelphia,11/24/2019,Walt Anderson,14,105,12,90,2,15,16,12,2019
Baltimore,LA Rams,11/25/2019,Craig Wrolstad,16,122,8,66,8,56,19,12,2019
Chicago,Detroit,11/28/2019,Jerome Boger,19,174,10,89,9,85,26,13,2019
Buffalo,Dallas,11/28/2019,Bill Vinovich,12,119,7,53,5,66,15,13,2019
New Orleans,Atlanta,11/28/2019,Shawn Smith,13,139,9,121,4,18,15,13,2019
San Francisco,Baltimore,12/01/2019,Brad Allen,9,77,6,54,3,23,10,13,2019
Washington,Carolina,12/01/2019,Scott Novak,11,108,6,65,5,43,11,13,2019
N.Y. Jets,Cincinnati,12/01/2019,Ron Torbert,12,121,10,106,2,15,12,13,2019
Tennessee,Indianapolis,12/01/2019,Carl Cheffers,9,73,3,33,6,40,10,13,2019
Tampa Bay,Jacksonville,12/01/2019,Walt Anderson,24,169,8,44,16,125,26,13,2019
Oakland,Kansas City,12/01/2019,John Hussey,12,99,12,99,0,0,15,13,2019
Philadelphia,Miami,12/01/2019,Adrian Hill,17,150,10,91,7,59,21,13,2019
Green Bay,N.Y. Giants,12/01/2019,Craig Wrolstad,11,85,7,54,4,31,14,13,2019
LA Rams,Arizona,12/01/2019,Alex Kemp,10,88,8,81,2,7,12,13,2019
LA Chargers,Denver,12/01/2019,Brad Rogers,10,107,7,82,3,25,13,13,2019
Cleveland,Pittsburgh,12/01/2019,Clay Martin,15,99,5,34,10,65,18,13,2019
New England,Houston,12/01/2019,Tony Corrente,16,139,8,60,8,79,18,13,2019
Minnesota,Seattle,12/02/2019,Clete Blakeman,4,60,3,30,1,30,4,13,2019
Dallas,Chicago,12/05/2019,Brad Rogers,10,82,6,52,4,30,10,14,2019
Carolina,Atlanta,12/08/2019,Clete Blakeman,13,102,7,44,6,58,14,14,2019
Baltimore,Buffalo,12/08/2019,Shawn Smith,14,148,9,99,5,49,18,14,2019
Cincinnati,Cleveland,12/08/2019,Carl Cheffers,14,129,8,99,6,30,16,14,2019
Washington,Green Bay,12/08/2019,Clay Martin,8,59,3,25,5,34,8,14,2019
Denver,Houston,12/08/2019,Adrian Hill,16,94,7,50,9,44,16,14,2019
Detroit,Minnesota,12/08/2019,Walt Anderson,12,83,4,28,8,55,15,14,2019
San Francisco,New Orleans,12/08/2019,John Hussey,15,117,10,67,5,50,16,14,2019
Miami,N.Y. Jets,12/08/2019,Craig Wrolstad,10,136,5,48,5,88,12,14,2019
Indianapolis,Tampa Bay,12/08/2019,Tony Corrente,9,139,3,35,6,104,14,14,2019
LA Chargers,Jacksonville,12/08/2019,Bill Vinovich,16,166,6,65,10,101,16,14,2019
Pittsburgh,Arizona,12/08/2019,Ron Torbert,11,95,4,20,7,75,11,14,2019
Kansas City,New England,12/08/2019,Jerome Boger,15,161,10,136,5,25,20,14,2019
Tennessee,Oakland,12/08/2019,Brad Allen,7,41,4,21,3,20,9,14,2019
Seattle,LA Rams,12/08/2019,Shawn Hochuli,11,84,8,64,3,20,12,14,2019
N.Y. Giants,Philadelphia,12/09/2019,Scott Novak,11,84,7,54,4,30,12,14,2019
N.Y. Jets,Baltimore,12/12/2019,John Hussey,14,129,8,94,6,35,15,15,2019
Seattle,Carolina,12/15/2019,Carl Cheffers,7,55,5,40,2,15,10,15,2019
New England,Cincinnati,12/15/2019,Alex Kemp,9,55,4,30,5,25,12,15,2019
Tampa Bay,Detroit,12/15/2019,Adrian Hill,11,80,9,70,2,10,12,15,2019
Chicago,Green Bay,12/15/2019,Scott Novak,8,65,4,35,4,30,9,15,2019
Denver,Kansas City,12/15/2019,Clete Blakeman,12,117,7,72,5,45,14,15,2019
Miami,N.Y. Giants,12/15/2019,Jerome Boger,11,74,7,42,4,32,15,15,2019
Buffalo,Pittsburgh,12/15/2019,Tony Corrente,14,100,8,70,6,30,16,15,2019
Houston,Tennessee,12/15/2019,Bill Vinovich,9,57,5,27,4,30,13,15,2019
Philadelphia,Washington,12/15/2019,Shawn Smith,12,114,7,54,5,60,15,15,2019
Cleveland,Arizona,12/15/2019,Brad Allen,11,89,6,55,5,34,13,15,2019
Jacksonville,Oakland,12/15/2019,Brad Rogers,14,138,8,87,6,51,14,15,2019
LA Rams,Dallas,12/15/2019,Walt Anderson,9,45,5,29,4,16,12,15,2019
Atlanta,San Francisco,12/15/2019,Craig Wrolstad,18,165,11,98,7,67,19,15,2019
Minnesota,LA Chargers,12/15/2019,Ron Torbert,10,89,5,41,5,48,10,15,2019
Indianapolis,New Orleans,12/16/2019,Shawn Hochuli,13,101,7,49,6,52,14,15,2019
Houston,Tampa Bay,12/21/2019,Scott Novak,10,80,4,35,6,45,12,16,2019
Buffalo,New England,12/21/2019,John Hussey,10,76,7,46,3,30,12,16,2019
LA Rams,San Francisco,12/21/2019,Clete Blakeman,10,69,7,43,3,26,11,16,2019
Detroit,Denver,12/22/2019,Craig Wrolstad,13,118,7,68,6,50,14,16,2019
Oakland,LA Chargers,12/22/2019,Clay Martin,7,62,5,47,2,15,8,16,2019
Jacksonville,Atlanta,12/22/2019,Adrian Hill,15,100,6,36,9,64,17,16,2019
Baltimore,Cleveland,12/22/2019,Alex Kemp,14,112,7,50,7,62,15,16,2019
Carolina,Indianapolis,12/22/2019,Walt Anderson,6,46,6,46,0,0,8,16,2019
Cincinnati,Miami,12/22/2019,Brad Allen,16,124,10,77,6,47,19,16,2019
Pittsburgh,N.Y. Jets,12/22/2019,Shawn Hochuli,7,64,4,34,3,30,9,16,2019
New Orleans,Tennessee,12/22/2019,Jerome Boger,17,126,11,70,6,56,21,16,2019
N.Y. Giants,Washington,12/22/2019,Ron Torbert,10,84,4,33,6,51,12,16,2019
Dallas,Philadelphia,12/22/2019,Tony Corrente,6,50,2,20,4,30,9,16,2019
Arizona,Seattle,12/22/2019,Brad Rogers,12,102,5,47,7,55,12,16,2019
Kansas City,Chicago,12/22/2019,Carl Cheffers,16,121,9,71,7,50,19,16,2019
Green Bay,Minnesota,12/23/2019,Bill Vinovich,5,50,2,20,3,30,6,16,2019
Pittsburgh,Baltimore,12/29/2019,Bill Vinovich,12,82,6,47,6,35,15,17,2019
N.Y. Jets,Buffalo,12/29/2019,Brad Rogers,7,53,2,13,5,40,7,17,2019
New Orleans,Carolina,12/29/2019,Ron Torbert,8,98,3,44,5,54,8,17,2019
Cleveland,Cincinnati,12/29/2019,Adrian Hill,7,53,4,33,3,20,7,17,2019
Washington,Dallas,12/29/2019,Craig Wrolstad,12,91,2,10,10,81,15,17,2019
Green Bay,Detroit,12/29/2019,Shawn Hochuli,13,147,9,97,4,50,14,17,2019
Tennessee,Houston,12/29/2019,Clete Blakeman,10,72,5,37,5,35,10,17,2019
Indianapolis,Jacksonville,12/29/2019,Brad Allen,7,63,4,36,3,27,8,17,2019
LA Chargers,Kansas City,12/29/2019,Walt Anderson,13,79,8,40,5,39,15,17,2019
Chicago,Minnesota,12/29/2019,John Hussey,6,74,3,34,3,40,6,17,2019
Miami,New England,12/29/2019,Clay Martin,10,89,4,35,6,54,12,17,2019
Philadelphia,N.Y. Giants,12/29/2019,Alex Kemp,11,103,7,55,4,48,14,17,2019
Atlanta,Tampa Bay,12/29/2019,Carl Cheffers,17,150,5,53,12,97,18,17,2019
Oakland,Denver,12/29/2019,Shawn Smith,19,168,10,107,9,61,21,17,2019
Arizona,LA Rams,12/29/2019,Jerome Boger,18,154,8,63,10,91,19,17,2019
San Francisco,Seattle,12/29/2019,Tony Corrente,13,86,8,57,5,29,13,17,2019
Houston,Kansas City,09/10/2020,Clete Blakeman,6,42,5,37,1,5,6,1,2020
Seattle,Atlanta,09/13/2020,Shawn Hochuli,12,118,6,46,6,72,13,1,2020
Cleveland,Baltimore,09/13/2020,Ron Torbert,15,146,8,80,7,66,15,1,2020
N.Y. Jets,Buffalo,09/13/2020,Shawn Smith,16,175,9,95,7,80,17,1,2020
Las Vegas,Carolina,09/13/2020,Brad Allen,8,105,3,40,5,65,10,1,2020
Chicago,Detroit,09/13/2020,Alex Kemp,14,125,6,48,8,77,17,1,2020
Indianapolis,Jacksonville,09/13/2020,John Hussey,11,141,5,80,6,61,15,1,2020
Green Bay,Minnesota,09/13/2020,Bill Vinovich,11,83,6,63,5,20,12,1,2020
Miami,New England,09/13/2020,Adrian Hill,7,82,4,35,3,47,8,1,2020
Philadelphia,Washington,09/13/2020,Brad Rogers,10,75,3,20,7,55,10,1,2020
LA Chargers,Cincinnati,09/13/2020,Clay Martin,13,79,6,35,7,44,16,1,2020
Tampa Bay,New Orleans,09/13/2020,Jerome Boger,15,222,9,103,6,119,15,1,2020
Arizona,San Francisco,09/13/2020,Carl Cheffers,14,155,9,102,5,53,15,1,2020
Dallas,LA Rams,09/13/2020,Tony Corrente,12,84,7,50,5,34,12,1,2020
Pittsburgh,N.Y. Giants,09/14/2020,Craig Wrolstad,7,46,3,21,4,25,7,1,2020
Tennessee,Denver,09/14/2020,Scott Novak,10,93,5,37,5,56,11,1,2020
Cincinnati,Cleveland,09/17/2020,Shawn Smith,12,121,4,45,8,76,14,2,2020
N.Y. Giants,Chicago,09/20/2020,Bill Vinovich,8,68,3,20,5,48,8,2,2020
Atlanta,Dallas,09/20/2020,Brad Rogers,15,126,8,51,7,75,20,2,2020
Detroit,Green Bay,09/20/2020,Clete Blakeman,15,130,7,70,8,60,18,2,2020
Minnesota,Indianapolis,09/20/2020,Alex Kemp,15,138,6,45,9,93,18,2,2020
Buffalo,Miami,09/20/2020,Jerome Boger,9,75,6,55,3,20,12,2,2020
San Francisco,N.Y. Jets,09/20/2020,Ron Torbert,10,124,5,59,5,65,12,2,2020
LA Rams,Philadelphia,09/20/2020,Brad Allen,9,54,4,24,5,30,10,2,2020
Denver,Pittsburgh,09/20/2020,Adrian Hill,14,119,4,30,10,89,15,2,2020
Carolina,Tampa Bay,09/20/2020,John Hussey,14,114,9,77,5,37,17,2,2020
Jacksonville,Tennessee,09/20/2020,Clay Martin,12,90,8,60,4,30,12,2,2020
Washington,Arizona,09/20/2020,Land Clark,17,139,6,42,11,97,19,2,2020
Baltimore,Houston,09/20/2020,Tony Corrente,7,43,3,21,4,22,8,2,2020
Kansas City,LA Chargers,09/20/2020,Carl Cheffers,17,130,11,90,6,40,19,2,2020
New England,Seattle,09/20/2020,Craig Wrolstad,11,80,2,12,9,68,12,2,2020
New Orleans,Las Vegas,09/21/2020,Shawn Hochuli,13,142,10,129,3,13,18,2,2020
Miami,Jacksonville,09/24/2020,Brad Allen,14,114,6,51,8,63,16,3,2020
Chicago,Atlanta,09/27/2020,Jerome Boger,17,155,10,80,7,75,19,3,2020
LA Rams,Buffalo,09/27/2020,Alex Kemp,8,85,3,30,5,55,12,3,2020
Washington,Cleveland,09/27/2020,Shawn Hochuli,10,90,4,40,6,50,11,3,2020
Tennessee,Minnesota,09/27/2020,Clete Blakeman,7,65,4,45,3,20,9,3,2020
Las Vegas,New England,09/27/2020,Ron Torbert,8,73,6,40,2,33,11,3,2020
San Francisco,N.Y. Giants,09/27/2020,Clay Martin,11,73,6,45,5,28,14,3,2020
Cincinnati,Philadelphia,09/27/2020,Adrian Hill,20,166,9,73,11,93,21,3,2020
Houston,Pittsburgh,09/27/2020,Shawn Smith,6,63,4,49,2,14,6,3,2020
N.Y. Jets,Indianapolis,09/27/2020,Craig Wrolstad,11,97,7,57,4,40,11,3,2020
Carolina,LA Chargers,09/27/2020,Tony Corrente,11,90,3,30,8,60,13,3,2020
Detroit,Arizona,09/27/2020,Scott Novak,14,94,7,46,7,48,16,3,2020
Tampa Bay,Denver,09/27/2020,Land Clark,13,101,9,71,4,30,20,3,2020
Dallas,Seattle,09/27/2020,Carl Cheffers,15,89,10,59,5,30,20,3,2020
Green Bay,New Orleans,09/27/2020,Brad Rogers,10,93,2,10,8,83,11,3,2020
Kansas City,Baltimore,09/28/2020,John Hussey,12,83,6,38,6,45,13,3,2020
Denver,N.Y. Jets,10/01/2020,Jerome Boger,19,212,8,94,11,118,21,4,2020
Arizona,Carolina,10/04/2020,Ron Torbert,15,101,5,29,10,72,16,4,2020
Indianapolis,Chicago,10/04/2020,Craig Wrolstad,16,179,8,76,8,103,17,4,2020
Jacksonville,Cincinnati,10/04/2020,Alex Kemp,13,122,6,49,7,73,17,4,2020
Cleveland,Dallas,10/04/2020,Clay Martin,11,105,5,40,6,65,12,4,2020
New Orleans,Detroit,10/04/2020,Shawn Smith,9,116,4,67,5,49,11,4,2020
Minnesota,Houston,10/04/2020,Brad Rogers,6,51,4,36,2,15,9,4,2020
Seattle,Miami,10/04/2020,Scott Novak,3,20,0,0,3,20,9,4,2020
LA Chargers,Tampa Bay,10/04/2020,Brad Allen,15,150,7,60,8,90,16,4,2020
Baltimore,Washington,10/04/2020,Adrian Hill,7,50,5,30,2,20,8,4,2020
N.Y. Giants,LA Rams,10/04/2020,John Hussey,5,25,4,20,1,5,7,4,2020
New England,Kansas City,10/05/2020,Tony Corrente,8,81,4,43,4,38,8,4,2020
Buffalo,Las Vegas,10/04/2020,Land Clark,12,147,5,81,7,66,16,4,2020
Philadelphia,San Francisco,10/04/2020,Bill Vinovich,9,67,3,25,6,42,10,4,2020
Atlanta,Green Bay,10/05/2020,Carl Cheffers,6,53,3,23,3,30,12,4,2020
Tampa Bay,Chicago,10/08/2020,Alex Kemp,17,175,11,109,6,66,22,5,2020
Carolina,Atlanta,10/11/2020,Brad Allen,7,65,4,25,3,40,11,5,2020
Cincinnati,Baltimore,10/11/2020,Jerome Boger,9,65,5,40,4,25,11,5,2020
Jacksonville,Houston,10/11/2020,Bill Vinovich,9,60,4,35,5,25,9,5,2020
Las Vegas,Kansas City,10/11/2020,Clete Blakeman,18,153,8,59,10,94,19,5,2020
Arizona,N.Y. Jets,10/11/2020,Adrian Hill,16,89,10,59,6,30,18,5,2020
Philadelphia,Pittsburgh,10/11/2020,Ron Torbert,17,170,9,84,8,86,19,5,2020
Buffalo,Tennessee,10/13/2020,Brad Rogers,16,102,10,56,6,46,22,5,2020
LA Rams,Washington,10/11/2020,Shawn Smith,8,100,5,60,3,40,8,5,2020
Miami,San Francisco,10/11/2020,Land Clark,14,144,7,69,7,75,14,5,2020
Indianapolis,Cleveland,10/11/2020,Scott Novak,7,40,5,30,2,10,8,5,2020
N.Y. Giants,Dallas,10/11/2020,Craig Wrolstad,11,106,8,81,3,25,14,5,2020
Minnesota,Seattle,10/11/2020,Tony Corrente,9,80,6,55,3,25,12,5,2020
LA Chargers,New Orleans,10/12/2020,Clay Martin,6,70,1,10,5,60,8,5,2020
Denver,New England,10/18/2020,Scott Novak,3,24,2,20,1,4,4,6,2020
Kansas City,Buffalo,10/19/2020,Ron Torbert,12,107,8,68,4,39,12,6,2020
Chicago,Carolina,10/18/2020,Adrian Hill,18,161,10,92,8,69,18,6,2020
Cincinnati,Indianapolis,10/18/2020,Land Clark,12,75,6,20,6,55,12,6,2020
Detroit,Jacksonville,10/18/2020,Shawn Hochuli,12,116,7,60,5,56,13,6,2020
Atlanta,Minnesota,10/18/2020,Craig Wrolstad,8,55,5,25,3,30,8,6,2020
Washington,N.Y. Giants,10/18/2020,Brad Allen,12,80,8,50,4,30,14,6,2020
Baltimore,Philadelphia,10/18/2020,Shawn Smith,15,152,12,132,3,20,19,6,2020
Cleveland,Pittsburgh,10/18/2020,John Hussey,13,100,7,55,6,45,13,6,2020
Houston,Tennessee,10/18/2020,Alex Kemp,11,119,4,46,7,73,11,6,2020
Green Bay,Tampa Bay,10/18/2020,Jerome Boger,6,76,6,76,0,0,9,6,2020
LA Rams,San Francisco,10/18/2020,Carl Cheffers,13,97,6,34,7,63,15,6,2020
Arizona,Dallas,10/19/2020,Clete Blakeman,13,79,7,43,6,36,15,6,2020
N.Y. Jets,Miami,10/18/2020,Bill Vinovich,12,105,7,80,5,25,16,6,2020
Pittsburgh,Tennessee,10/25/2020,Shawn Hochuli,15,142,8,69,7,73,16,7,2020
N.Y. Giants,Philadelphia,10/22/2020,Adrian Hill,16,137,9,62,7,75,19,7,2020
Detroit,Atlanta,10/25/2020,Land Clark,13,103,5,50,8,53,15,7,2020
Cleveland,Cincinnati,10/25/2020,Tony Corrente,12,85,5,40,7,45,15,7,2020
Green Bay,Houston,10/25/2020,Clay Martin,11,95,5,40,6,55,12,7,2020
Carolina,New Orleans,10/25/2020,Craig Wrolstad,7,55,1,5,6,50,9,7,2020
Buffalo,N.Y. Jets,10/25/2020,Carl Cheffers,17,155,11,106,6,49,19,7,2020
Dallas,Washington,10/25/2020,Ron Torbert,10,79,6,49,4,30,13,7,2020
Seattle,Arizona,10/25/2020,John Hussey,14,118,8,78,6,40,16,7,2020
Kansas City,Denver,10/25/2020,Brad Rogers,6,49,1,15,5,34,10,7,2020
San Francisco,New England,10/25/2020,Shawn Smith,9,95,6,65,3,30,9,7,2020
Tampa Bay,Las Vegas,10/25/2020,Scott Novak,8,55,4,20,4,35,13,7,2020
Chicago,LA Rams,10/26/2020,Bill Vinovich,10,92,6,46,4,46,14,7,2020
Jacksonville,LA Chargers,10/25/2020,Clete Blakeman,9,90,6,55,3,35,9,7,2020
Pittsburgh,Baltimore,11/01/2020,Brad Allen,12,140,3,30,9,110,14,8,2020
Atlanta,Carolina,10/29/2020,Shawn Hochuli,12,93,6,63,6,30,16,8,2020
New England,Buffalo,11/01/2020,Clete Blakeman,10,65,5,35,5,30,11,8,2020
Tennessee,Cincinnati,11/01/2020,Scott Novak,14,113,7,68,7,45,14,8,2020
Las Vegas,Cleveland,11/01/2020,Bill Vinovich,12,84,5,25,7,59,12,8,2020
Indianapolis,Detroit,11/01/2020,Clay Martin,7,95,3,19,4,76,9,8,2020
Minnesota,Green Bay,11/01/2020,Alex Kemp,16,121,7,36,9,85,19,8,2020
N.Y. Jets,Kansas City,11/01/2020,Land Clark,10,86,3,25,7,61,14,8,2020
LA Rams,Miami,11/01/2020,John Hussey,8,75,5,45,3,30,12,8,2020
New Orleans,Chicago,11/01/2020,Tony Corrente,12,98,5,45,7,53,13,8,2020
San Francisco,Seattle,11/01/2020,Craig Wrolstad,12,66,6,36,6,30,14,8,2020
Dallas,Philadelphia,11/01/2020,Jerome Boger,11,96,7,68,4,28,13,8,2020
Tampa Bay,N.Y. Giants,11/02/2020,Brad Rogers,10,93,3,20,7,73,11,8,2020
LA Chargers,Denver,11/01/2020,Carl Cheffers,14,137,6,67,8,70,19,8,2020
Green Bay,San Francisco,11/05/2020,Bill Vinovich,9,78,5,45,4,33,10,9,2020
Denver,Atlanta,11/08/2020,Jerome Boger,10,126,5,65,5,61,15,9,2020
Seattle,Buffalo,11/08/2020,Shawn Smith,10,83,4,13,6,70,12,9,2020
Baltimore,Indianapolis,11/08/2020,Adrian Hill,9,85,5,55,4,30,13,9,2020
Houston,Jacksonville,11/08/2020,Brad Allen,7,96,3,18,4,78,8,9,2020
Carolina,Kansas City,11/08/2020,Clay Martin,20,157,12,82,8,75,22,9,2020
Detroit,Minnesota,11/08/2020,Clete Blakeman,12,106,3,37,9,69,12,9,2020
Chicago,Tennessee,11/08/2020,Ron Torbert,11,92,5,35,6,57,12,9,2020
N.Y. Giants,Washington,11/08/2020,Shawn Hochuli,10,85,4,40,6,45,11,9,2020
Las Vegas,LA Chargers,11/08/2020,Brad Rogers,7,55,2,10,5,45,8,9,2020
Miami,Arizona,11/08/2020,Carl Cheffers,14,146,7,75,7,71,24,9,2020
Pittsburgh,Dallas,11/08/2020,Tony Corrente,10,86,3,16,7,70,13,9,2020
New Orleans,Tampa Bay,11/08/2020,John Hussey,8,67,3,28,5,39,8,9,2020
New England,N.Y. Jets,11/09/2020,Alex Kemp,10,113,6,81,4,32,14,9,2020
LA Chargers,Miami,11/15/2020,Jerome Boger,8,46,5,31,3,15,8,10,2020
Indianapolis,Tennessee,11/12/2020,Brad Allen,12,103,9,73,3,30,13,10,2020
Tampa Bay,Carolina,11/15/2020,Land Clark,8,70,3,30,5,40,8,10,2020
Houston,Cleveland,11/15/2020,Ron Torbert,12,112,6,49,6,63,13,10,2020
Washington,Detroit,11/15/2020,Alex Kemp,15,113,6,58,9,55,18,10,2020
Jacksonville,Green Bay,11/15/2020,Shawn Smith,11,121,7,86,4,35,14,10,2020
Philadelphia,N.Y. Giants,11/15/2020,Clay Martin,18,138,11,74,7,64,18,10,2020
Cincinnati,Pittsburgh,11/15/2020,Adrian Hill,12,110,6,65,6,45,13,10,2020
Buffalo,Arizona,11/15/2020,Craig Wrolstad,16,109,9,69,7,40,20,10,2020
Denver,Las Vegas,11/15/2020,Tony Corrente,15,119,7,37,8,82,17,10,2020
Seattle,LA Rams,11/15/2020,Clete Blakeman,8,72,4,23,4,49,9,10,2020
San Francisco,New Orleans,11/15/2020,Brad Rogers,11,112,6,51,5,61,15,10,2020
Baltimore,New England,11/15/2020,Shawn Hochuli,11,82,8,64,3,18,13,10,2020
Minnesota,Chicago,11/16/2020,Scott Novak,5,40,4,35,1,5,5,10,2020
Miami,Denver,11/22/2020,Land Clark,13,120,5,50,8,70,15,11,2020
N.Y. Jets,LA Chargers,11/22/2020,Craig Wrolstad,17,166,8,88,9,78,18,11,2020
Arizona,Seattle,11/19/2020,Tony Corrente,18,194,10,115,8,79,20,11,2020
Tennessee,Baltimore,11/22/2020,Alex Kemp,10,125,4,44,6,81,11,11,2020
Detroit,Carolina,11/22/2020,Ron Torbert,11,65,4,20,7,45,12,11,2020
Philadelphia,Cleveland,11/22/2020,Adrian Hill,8,86,5,33,3,53,11,11,2020
New England,Houston,11/22/2020,John Hussey,12,90,7,55,5,35,14,11,2020
Green Bay,Indianapolis,11/22/2020,Shawn Hochuli,15,161,7,45,8,116,20,11,2020
Pittsburgh,Jacksonville,11/22/2020,Scott Novak,14,147,6,42,8,105,14,11,2020
Atlanta,New Orleans,11/22/2020,Brad Allen,12,88,7,53,5,35,16,11,2020
Cincinnati,Washington,11/22/2020,Shawn Smith,9,80,3,31,6,49,10,11,2020
Dallas,Minnesota,11/22/2020,Bill Vinovich,12,110,4,30,8,80,13,11,2020
Kansas City,Las Vegas,11/22/2020,Carl Cheffers,18,161,10,89,8,72,21,11,2020
LA Rams,Tampa Bay,11/23/2020,Jerome Boger,7,72,5,65,2,7,9,11,2020
Houston,Detroit,11/26/2020,Shawn Smith,14,118,10,74,4,44,20,12,2020
Washington,Dallas,11/26/2020,Clay Martin,10,98,5,53,5,45,10,12,2020
Baltimore,Pittsburgh,12/02/2020,Ron Torbert,12,126,7,86,5,40,12,12,2020
Las Vegas,Atlanta,11/29/2020,Land Clark,17,190,11,141,6,49,20,12,2020
LA Chargers,Buffalo,11/29/2020,Alex Kemp,14,176,5,91,9,85,20,12,2020
N.Y. Giants,Cincinnati,11/29/2020,Carl Cheffers,8,78,5,51,3,27,9,12,2020
Tennessee,Indianapolis,11/29/2020,John Hussey,15,113,9,63,6,50,19,12,2020
Cleveland,Jacksonville,11/29/2020,Jerome Boger,11,71,6,47,5,24,12,12,2020
Carolina,Minnesota,11/29/2020,Brad Rogers,15,110,7,58,8,52,16,12,2020
Arizona,New England,11/29/2020,Bill Vinovich,12,92,6,50,6,42,14,12,2020
Miami,N.Y. Jets,11/29/2020,Adrian Hill,9,94,3,20,6,74,10,12,2020
New Orleans,Denver,11/29/2020,Craig Wrolstad,7,45,5,35,2,10,9,12,2020
San Francisco,LA Rams,11/29/2020,Scott Novak,8,67,5,40,3,27,9,12,2020
Kansas City,Tampa Bay,11/29/2020,Shawn Hochuli,18,139,10,82,8,57,21,12,2020
Chicago,Green Bay,11/29/2020,Clete Blakeman,8,62,5,45,3,17,8,12,2020
Seattle,Philadelphia,11/30/2020,Brad Allen,17,162,8,83,9,79,19,12,2020
Dallas,Baltimore,12/08/2020,Brad Rogers,11,81,7,58,4,23,13,13,2020
New Orleans,Atlanta,12/06/2020,Adrian Hill,11,94,10,79,1,15,12,13,2020
Detroit,Chicago,12/06/2020,Clay Martin,10,65,7,45,3,20,14,13,2020
Indianapolis,Houston,12/06/2020,Scott Novak,10,80,7,50,3,30,12,13,2020
Cincinnati,Miami,12/06/2020,Ron Torbert,14,116,6,62,8,54,23,13,2020
Jacksonville,Minnesota,12/06/2020,Land Clark,16,124,10,83,6,41,17,13,2020
Las Vegas,N.Y. Jets,12/06/2020,Shawn Smith,9,61,3,21,6,40,11,13,2020
Washington,Pittsburgh,12/07/2020,John Hussey,15,107,9,62,6,45,19,13,2020
Cleveland,Tennessee,12/06/2020,Clete Blakeman,18,144,13,92,5,52,20,13,2020
LA Rams,Arizona,12/06/2020,Shawn Hochuli,11,96,6,75,5,21,12,13,2020
N.Y. Giants,Seattle,12/06/2020,Craig Wrolstad,12,76,6,35,6,41,14,13,2020
Philadelphia,Green Bay,12/06/2020,Bill Vinovich,9,70,4,40,5,30,9,13,2020
New England,LA Chargers,12/06/2020,Carl Cheffers,8,45,3,15,5,30,9,13,2020
Denver,Kansas City,12/06/2020,Alex Kemp,9,75,4,31,5,44,11,13,2020
Buffalo,San Francisco,12/07/2020,Tony Corrente,11,93,4,50,7,43,12,13,2020
New England,LA Rams,12/10/2020,Craig Wrolstad,10,62,5,27,5,35,10,14,2020
Denver,Carolina,12/13/2020,Shawn Hochuli,9,66,2,18,7,48,13,14,2020
Houston,Chicago,12/13/2020,Land Clark,13,94,6,50,7,44,14,14,2020
Dallas,Cincinnati,12/13/2020,John Hussey,8,55,5,30,3,25,10,14,2020
Green Bay,Detroit,12/13/2020,Alex Kemp,16,98,12,68,4,30,17,14,2020
Tennessee,Jacksonville,12/13/2020,Adrian Hill,17,158,7,78,10,80,19,14,2020
Kansas City,Miami,12/13/2020,Clay Martin,11,91,8,56,3,35,12,14,2020
Arizona,N.Y. Giants,12/13/2020,Ron Torbert,6,32,4,22,2,10,6,14,2020
Minnesota,Tampa Bay,12/13/2020,Brad Allen,10,105,5,71,5,34,12,14,2020
Indianapolis,Las Vegas,12/13/2020,Clete Blakeman,12,83,6,50,6,33,12,14,2020
N.Y. Jets,Seattle,12/13/2020,Scott Novak,11,85,7,50,4,35,12,14,2020
Atlanta,LA Chargers,12/13/2020,Tony Corrente,10,75,4,35,6,40,11,14,2020
New Orleans,Philadelphia,12/13/2020,Jerome Boger,14,79,8,52,6,27,15,14,2020
Washington,San Francisco,12/13/2020,Carl Cheffers,10,65,5,30,5,35,13,14,2020
Pittsburgh,Buffalo,12/13/2020,Shawn Smith,10,103,3,55,7,48,13,14,2020
Baltimore,Cleveland,12/14/2020,Bill Vinovich,16,144,8,69,8,75,19,14,2020
LA Chargers,Las Vegas,12/17/2020,John Hussey,9,89,3,20,6,69,9,15,2020
Buffalo,Denver,12/19/2020,Clete Blakeman,15,108,8,75,7,33,17,15,2020
Carolina,Green Bay,12/19/2020,Alex Kemp,12,116,7,66,5,50,14,15,2020
Houston,Indianapolis,12/20/2020,Bill Vinovich,9,59,5,24,4,35,9,15,2020
N.Y. Jets,LA Rams,12/20/2020,Tony Corrente,11,104,6,61,5,43,12,15,2020
Detroit,Tennessee,12/20/2020,Jerome Boger,6,55,3,33,3,22,8,15,2020
Tampa Bay,Atlanta,12/20/2020,Brad Rogers,4,38,1,10,3,28,7,15,2020
Jacksonville,Baltimore,12/20/2020,Carl Cheffers,11,107,7,67,4,40,13,15,2020
New England,Miami,12/20/2020,Brad Allen,9,60,2,20,7,40,10,15,2020
Chicago,Minnesota,12/20/2020,Shawn Smith,5,41,4,36,1,5,5,15,2020
Cleveland,N.Y. Giants,12/20/2020,Shawn Hochuli,8,85,6,60,2,25,11,15,2020
Seattle,Washington,12/20/2020,Adrian Hill,10,86,4,45,6,41,12,15,2020
Philadelphia,Arizona,12/20/2020,Craig Wrolstad,18,152,9,69,9,83,19,15,2020
Kansas City,New Orleans,12/20/2020,Scott Novak,15,147,5,54,10,93,18,15,2020
San Francisco,Dallas,12/20/2020,Land Clark,9,97,4,39,5,58,12,15,2020
Pittsburgh,Cincinnati,12/21/2020,Clay Martin,6,46,4,30,2,16,9,15,2020
Minnesota,New Orleans,12/25/2020,Adrian Hill,7,58,3,20,4,38,9,16,2020
San Francisco,Arizona,12/26/2020,Clete Blakeman,8,47,4,27,4,20,8,16,2020
Tampa Bay,Detroit,12/26/2020,Scott Novak,19,182,8,65,11,117,20,16,2020
Denver,LA Chargers,12/27/2020,Shawn Hochuli,12,89,6,44,6,45,12,16,2020
Miami,Las Vegas,12/26/2020,Tony Corrente,9,116,5,76,4,40,10,16,2020
Cleveland,N.Y. Jets,12/27/2020,Land Clark,13,109,6,51,7,58,17,16,2020
N.Y. Giants,Baltimore,12/27/2020,John Hussey,15,100,5,35,10,65,18,16,2020
Cincinnati,Houston,12/27/2020,Brad Rogers,11,81,5,35,6,46,14,16,2020
Chicago,Jacksonville,12/27/2020,Jerome Boger,14,155,4,40,10,115,15,16,2020
Atlanta,Kansas City,12/27/2020,Craig Wrolstad,13,86,7,45,6,41,16,16,2020
Indianapolis,Pittsburgh,12/27/2020,Alex Kemp,15,132,9,83,6,49,16,16,2020
Carolina,Washington,12/27/2020,Carl Cheffers,8,61,3,35,5,26,10,16,2020
LA Rams,Seattle,12/27/2020,Bill Vinovich,10,76,5,45,5,31,13,16,2020
Philadelphia,Dallas,12/27/2020,Shawn Smith,17,188,12,115,5,73,19,16,2020
Tennessee,Green Bay,12/27/2020,Brad Allen,3,15,3,15,0,0,3,16,2020
Buffalo,New England,12/28/2020,Ron Torbert,7,52,3,27,4,25,8,16,2020
Miami,Buffalo,01/03/2021,Bill Vinovich,5,36,2,20,3,16,7,17,2020
New Orleans,Carolina,01/03/2021,Adrian Hill,5,36,4,31,1,5,6,17,2020
Green Bay,Chicago,01/03/2021,Craig Wrolstad,5,46,4,30,1,16,5,17,2020
Baltimore,Cincinnati,01/03/2021,Land Clark,9,78,6,49,3,29,12,17,2020
Pittsburgh,Cleveland,01/03/2021,Jerome Boger,6,34,2,15,4,19,7,17,2020
Minnesota,Detroit,01/03/2021,John Hussey,11,86,4,35,7,51,12,17,2020
LA Chargers,Kansas City,01/03/2021,Clete Blakeman,9,92,4,23,5,69,9,17,2020
N.Y. Jets,New England,01/03/2021,Brad Rogers,9,77,3,30,6,47,10,17,2020
Dallas,N.Y. Giants,01/03/2021,Brad Allen,12,103,6,58,6,45,15,17,2020
Washington,Philadelphia,01/03/2021,Ron Torbert,11,97,5,56,6,41,12,17,2020
Atlanta,Tampa Bay,01/03/2021,Alex Kemp,7,71,4,48,3,23,9,17,2020
Las Vegas,Denver,01/03/2021,Scott Novak,18,139,14,111,4,28,18,17,2020
Tennessee,Houston,01/03/2021,Shawn Hochuli,12,94,6,50,6,44,12,17,2020
Jacksonville,Indianapolis,01/03/2021,Shawn Smith,4,69,3,54,1,15,4,17,2020
Arizona,LA Rams,01/03/2021,Carl Cheffers,11,76,6,38,5,38,14,17,2020
Seattle,San Francisco,01/03/2021,Tony Corrente,6,60,4,35,2,25,10,17,2020
Dallas,Tampa Bay,09/09/2021,Shawn Hochuli,19,161,8,55,11,106,24,1,2021
Philadelphia,Atlanta,09/12/2021,Scott Novak,26,188,14,89,12,99,27,1,2021
Pittsburgh,Buffalo,09/12/2021,John Hussey,13,113,5,32,8,81,16,1,2021
N.Y. Jets,Carolina,09/12/2021,Clay Martin,11,68,5,30,6,38,14,1,2021
Minnesota,Cincinnati,09/12/2021,Adrian Hill,15,131,12,116,3,15,19,1,2021
San Francisco,Detroit,09/12/2021,Brad Rogers,12,124,7,79,5,45,14,1,2021
Jacksonville,Houston,09/12/2021,Land Clark,15,132,10,82,5,50,20,1,2021
Seattle,Indianapolis,09/12/2021,Tony Corrente,9,69,7,53,2,16,9,1,2021
Arizona,Tennessee,09/12/2021,Jerome Boger,15,116,8,59,7,57,19,1,2021
LA Chargers,Washington,09/12/2021,Alex Kemp,14,151,6,94,8,57,17,1,2021
Cleveland,Kansas City,09/12/2021,Bill Vinovich,10,66,5,30,5,36,16,1,2021
Miami,New England,09/12/2021,Clete Blakeman,13,112,5,28,8,84,14,1,2021
Green Bay,New Orleans,09/12/2021,Carl Cheffers,11,69,5,33,6,36,12,1,2021
Denver,N.Y. Giants,09/12/2021,Ron Torbert,9,99,5,51,4,48,11,1,2021
Chicago,LA Rams,09/12/2021,Brad Allen,7,71,3,35,4,36,9,1,2021
Baltimore,Las Vegas,09/13/2021,Shawn Smith,15,133,5,71,10,62,16,1,2021
N.Y. Giants,Washington,09/16/2021,Scott Novak,20,161,11,81,9,80,20,2,2021
New Orleans,Carolina,09/19/2021,Ron Torbert,16,164,11,115,5,49,17,2,2021
Cincinnati,Chicago,09/19/2021,Land Clark,12,127,4,57,8,70,14,2,2021
Houston,Cleveland,09/19/2021,Brad Rogers,14,140,9,78,5,62,19,2,2021
LA Rams,Indianapolis,09/19/2021,Shawn Smith,5,40,2,15,3,25,5,2,2021
Denver,Jacksonville,09/19/2021,Clay Martin,17,171,10,101,7,70,17,2,2021
Buffalo,Miami,09/19/2021,Craig Wrolstad,15,136,6,53,9,83,19,2,2021
New England,N.Y. Jets,09/19/2021,Shawn Hochuli,14,131,6,54,8,77,15,2,2021
San Francisco,Philadelphia,09/19/2021,Brad Allen,13,117,5,60,8,57,15,2,2021
Las Vegas,Pittsburgh,09/19/2021,Jerome Boger,10,83,5,40,5,43,14,2,2021
Minnesota,Arizona,09/19/2021,Bill Vinovich,8,56,3,16,5,40,12,2,2021
Atlanta,Tampa Bay,09/19/2021,Carl Cheffers,15,132,6,49,9,83,15,2,2021
Dallas,LA Chargers,09/19/2021,Tony Corrente,20,175,8,76,12,99,23,2,2021
Tennessee,Seattle,09/19/2021,John Hussey,15,145,5,45,10,100,17,2,2021
Kansas City,Baltimore,09/19/2021,Clete Blakeman,13,101,5,46,8,55,13,2,2021
Detroit,Green Bay,09/20/2021,Adrian Hill,14,128,9,78,5,50,16,2,2021
Carolina,Houston,09/23/2021,Alex Kemp,15,115,8,64,7,51,16,3,2021
Washington,Buffalo,09/26/2021,Tony Corrente,10,68,5,38,5,30,12,3,2021
Chicago,Cleveland,09/26/2021,Ron Torbert,12,142,5,44,7,98,13,3,2021
Baltimore,Detroit,09/26/2021,Scott Novak,13,104,6,69,7,35,15,3,2021
Arizona,Jacksonville,09/26/2021,Shawn Smith,11,98,7,58,4,40,12,3,2021
LA Chargers,Kansas City,09/26/2021,Shawn Hochuli,14,106,8,50,6,56,17,3,2021
New Orleans,New England,09/26/2021,John Hussey,6,45,2,15,4,30,8,3,2021
Atlanta,N.Y. Giants,09/26/2021,Adrian Hill,12,81,4,28,8,53,15,3,2021
Cincinnati,Pittsburgh,09/26/2021,Clete Blakeman,20,162,10,89,10,73,21,3,2021
Indianapolis,Tennessee,09/26/2021,Bill Vinovich,8,90,4,66,4,24,8,3,2021
N.Y. Jets,Denver,09/26/2021,Land Clark,14,139,8,89,6,50,16,3,2021
Miami,Las Vegas,09/26/2021,Carl Cheffers,16,172,8,68,8,104,19,3,2021
Tampa Bay,LA Rams,09/26/2021,Craig Wrolstad,8,45,7,41,1,4,9,3,2021
Seattle,Minnesota,09/26/2021,Clay Martin,8,75,4,35,4,40,8,3,2021
Green Bay,San Francisco,09/26/2021,Jerome Boger,11,173,7,87,4,86,14,3,2021
Philadelphia,Dallas,09/27/2021,Brad Rogers,17,123,13,86,4,37,22,3,2021
Jacksonville,Cincinnati,09/30/2021,Brad Allen,8,48,2,10,6,38,11,4,2021
Washington,Atlanta,10/03/2021,Clay Martin,13,121,6,85,7,36,15,4,2021
Houston,Buffalo,10/03/2021,Ron Torbert,13,130,10,100,3,30,13,4,2021
Detroit,Chicago,10/03/2021,Shawn Smith,11,87,4,26,7,61,16,4,2021
Carolina,Dallas,10/03/2021,Jerome Boger,13,82,6,32,7,50,16,4,2021
Indianapolis,Miami,10/03/2021,Alex Kemp,13,118,8,86,5,32,17,4,2021
Cleveland,Minnesota,10/03/2021,Tony Corrente,14,115,7,73,7,42,14,4,2021
N.Y. Giants,New Orleans,10/03/2021,Brad Rogers,8,60,3,25,5,35,8,4,2021
Tennessee,N.Y. Jets,10/03/2021,Adrian Hill,14,163,8,98,6,65,17,4,2021
Kansas City,Philadelphia,10/03/2021,Land Clark,16,95,7,46,9,49,18,4,2021
Arizona,LA Rams,10/03/2021,Shawn Hochuli,12,99,7,63,5,36,13,4,2021
Seattle,San Francisco,10/03/2021,Carl Cheffers,13,105,5,27,8,78,13,4,2021
Baltimore,Denver,10/03/2021,Craig Wrolstad,10,80,6,55,4,25,13,4,2021
Pittsburgh,Green Bay,10/03/2021,Scott Novak,8,59,5,34,3,25,11,4,2021
Tampa Bay,New England,10/03/2021,Bill Vinovich,15,151,7,74,8,77,15,4,2021
Las Vegas,LA Chargers,10/04/2021,John Hussey,14,163,7,58,7,105,15,4,2021
LA Rams,Seattle,10/07/2021,Ron Torbert,8,105,5,85,3,20,9,5,2021
N.Y. Jets,Atlanta,10/10/2021,Tony Corrente,11,124,7,58,4,66,13,5,2021
Philadelphia,Carolina,10/10/2021,Shawn Hochuli,15,129,6,60,9,69,16,5,2021
Green Bay,Cincinnati,10/10/2021,Bill Vinovich,4,31,2,10,2,21,5,5,2021
New England,Houston,10/10/2021,Scott Novak,13,97,5,27,8,70,13,5,2021
Tennessee,Jacksonville,10/10/2021,Alex Kemp,11,77,7,44,4,33,12,5,2021
Detroit,Minnesota,10/10/2021,Clete Blakeman,10,104,3,30,7,74,11,5,2021
Denver,Pittsburgh,10/10/2021,Brad Rogers,15,126,7,67,8,59,16,5,2021
Miami,Tampa Bay,10/10/2021,Jerome Boger,11,84,5,37,6,47,14,5,2021
New Orleans,Washington,10/10/2021,Shawn Smith,11,82,6,45,5,37,13,5,2021
Cleveland,LA Chargers,10/10/2021,Brad Allen,13,126,7,77,6,49,19,5,2021
Chicago,Las Vegas,10/10/2021,Craig Wrolstad,18,152,8,70,10,82,22,5,2021
San Francisco,Arizona,10/10/2021,Clay Martin,13,122,7,60,6,62,16,5,2021
N.Y. Giants,Dallas,10/10/2021,John Hussey,13,106,5,48,8,58,15,5,2021
Buffalo,Kansas City,10/10/2021,Carl Cheffers,17,158,10,103,7,55,23,5,2021
Indianapolis,Baltimore,10/11/2021,Land Clark,13,119,5,45,8,74,16,5,2021
Tampa Bay,Philadelphia,10/14/2021,Clay Martin,11,161,7,120,4,41,11,6,2021
Miami,Jacksonville,10/17/2021,John Hussey,15,109,7,55,8,54,15,6,2021
LA Chargers,Baltimore,10/17/2021,Bill Vinovich,6,50,4,35,2,15,6,6,2021
Minnesota,Carolina,10/17/2021,Craig Wrolstad,17,126,11,98,6,28,19,6,2021
Green Bay,Chicago,10/17/2021,Brad Rogers,10,105,3,51,7,54,14,6,2021
Cincinnati,Detroit,10/17/2021,Shawn Hochuli,13,108,4,31,9,77,16,6,2021
Houston,Indianapolis,10/17/2021,Jerome Boger,6,35,4,25,2,10,10,6,2021
LA Rams,N.Y. Giants,10/17/2021,Alex Kemp,12,77,7,50,5,27,14,6,2021
Kansas City,Washington,10/17/2021,Adrian Hill,11,91,5,47,6,44,15,6,2021
Arizona,Cleveland,10/17/2021,Carl Cheffers,14,133,5,45,9,88,15,6,2021
Las Vegas,Denver,10/17/2021,Ron Torbert,12,107,6,54,6,53,13,6,2021
Dallas,New England,10/17/2021,Brad Allen,17,162,12,115,5,47,19,6,2021
Seattle,Pittsburgh,10/17/2021,Shawn Smith,11,83,6,45,5,38,12,6,2021
Buffalo,Tennessee,10/18/2021,Clete Blakeman,15,151,8,60,7,91,22,6,2021
Denver,Cleveland,10/21/2021,Adrian Hill,11,75,2,15,9,60,12,7,2021
Cincinnati,Baltimore,10/24/2021,Tony Corrente,6,51,1,5,5,46,7,7,2021
Washington,Green Bay,10/24/2021,Ron Torbert,8,86,4,50,4,36,10,7,2021
Atlanta,Miami,10/24/2021,Scott Novak,9,73,3,29,6,44,14,7,2021
N.Y. Jets,New England,10/24/2021,Brad Rogers,11,124,5,29,6,95,13,7,2021
Carolina,N.Y. Giants,10/24/2021,Carl Cheffers,15,97,7,37,8,60,15,7,2021
Kansas City,Tennessee,10/24/2021,Brad Allen,15,108,9,77,6,31,15,7,2021
Detroit,LA Rams,10/24/2021,Bill Vinovich,12,112,8,77,4,35,16,7,2021
Philadelphia,Las Vegas,10/24/2021,Clete Blakeman,11,102,4,37,7,65,12,7,2021
Houston,Arizona,10/24/2021,Land Clark,15,134,8,80,7,54,15,7,2021
Chicago,Tampa Bay,10/24/2021,Alex Kemp,5,42,4,32,1,10,5,7,2021
Indianapolis,San Francisco,10/24/2021,Craig Wrolstad,13,167,6,45,7,122,17,7,2021
New Orleans,Seattle,10/25/2021,Shawn Hochuli,13,143,7,90,6,53,13,7,2021
Green Bay,Arizona,10/28/2021,Alex Kemp,14,119,7,60,7,59,14,8,2021
Carolina,Atlanta,10/31/2021,Brad Allen,11,91,8,76,3,15,12,8,2021
Miami,Buffalo,10/31/2021,Shawn Smith,18,138,9,58,9,80,22,8,2021
San Francisco,Chicago,10/31/2021,Land Clark,11,85,7,55,4,30,13,8,2021
Pittsburgh,Cleveland,10/31/2021,Shawn Hochuli,13,95,8,65,5,30,17,8,2021
Philadelphia,Detroit,10/31/2021,Tony Corrente,10,65,2,15,8,50,11,8,2021
LA Rams,Houston,10/31/2021,Clay Martin,9,58,3,20,6,38,12,8,2021
Tennessee,Indianapolis,10/31/2021,Carl Cheffers,20,236,11,161,9,75,21,8,2021
Cincinnati,N.Y. Jets,10/31/2021,Craig Wrolstad,13,97,5,51,8,46,15,8,2021
New England,LA Chargers,10/31/2021,Ron Torbert,9,70,4,30,5,40,12,8,2021
Jacksonville,Seattle,10/31/2021,Adrian Hill,17,133,12,93,5,40,17,8,2021
Washington,Denver,10/31/2021,John Hussey,8,64,4,29,4,35,10,8,2021
Tampa Bay,New Orleans,10/31/2021,Clete Blakeman,13,109,11,99,2,10,14,8,2021
Dallas,Minnesota,10/31/2021,Scott Novak,18,153,11,96,7,57,21,8,2021
N.Y. Giants,Kansas City,11/01/2021,Jerome Boger,22,191,10,88,12,103,23,8,2021
N.Y. Jets,Indianapolis,11/04/2021,John Hussey,9,65,7,43,2,22,11,9,2021
Minnesota,Baltimore,11/07/2021,Carl Cheffers,16,168,8,107,8,61,17,9,2021
New England,Carolina,11/07/2021,Clete Blakeman,16,118,6,35,10,83,16,9,2021
Cleveland,Cincinnati,11/07/2021,Scott Novak,14,115,10,84,4,31,17,9,2021
Denver,Dallas,11/07/2021,Bill Vinovich,10,75,5,37,5,38,11,9,2021
Buffalo,Jacksonville,11/07/2021,Land Clark,20,172,12,118,8,54,21,9,2021
Houston,Miami,11/07/2021,Adrian Hill,10,73,8,60,2,13,12,9,2021
Atlanta,New Orleans,11/07/2021,Alex Kemp,16,150,6,76,10,74,17,9,2021
Las Vegas,N.Y. Giants,11/07/2021,Clay Martin,10,100,6,65,4,35,11,9,2021
LA Chargers,Philadelphia,11/07/2021,Jerome Boger,7,55,4,30,3,25,7,9,2021
Green Bay,Kansas City,11/07/2021,Shawn Smith,10,52,4,19,6,33,13,9,2021
Arizona,San Francisco,11/07/2021,Brad Allen,12,119,9,84,3,35,12,9,2021
Tennessee,LA Rams,11/07/2021,Brad Rogers,16,134,4,19,12,115,20,9,2021
Chicago,Pittsburgh,11/08/2021,Tony Corrente,17,145,12,115,5,30,23,9,2021
Baltimore,Miami,11/11/2021,Ron Torbert,15,117,4,20,11,97,17,10,2021
Atlanta,Dallas,11/14/2021,Craig Wrolstad,14,121,6,41,8,80,15,10,2021
Jacksonville,Indianapolis,11/14/2021,Tony Corrente,15,126,8,79,7,47,18,10,2021
Cleveland,New England,11/14/2021,John Hussey,12,88,6,42,6,46,13,10,2021
Buffalo,N.Y. Jets,11/14/2021,Scott Novak,16,119,7,50,9,69,21,10,2021
Detroit,Pittsburgh,11/14/2021,Land Clark,15,143,8,84,7,59,22,10,2021
New Orleans,Tennessee,11/14/2021,Jerome Boger,17,114,9,65,8,49,17,10,2021
Tampa Bay,Washington,11/14/2021,Brad Rogers,9,76,6,43,3,33,10,10,2021
Carolina,Arizona,11/14/2021,Adrian Hill,13,173,9,115,4,58,17,10,2021
Minnesota,LA Chargers,11/14/2021,Clay Martin,17,170,10,118,7,52,18,10,2021
Philadelphia,Denver,11/14/2021,Shawn Hochuli,11,118,7,89,4,29,11,10,2021
Seattle,Green Bay,11/14/2021,Brad Allen,8,82,5,39,3,43,11,10,2021
Kansas City,Las Vegas,11/14/2021,Bill Vinovich,13,102,4,34,9,68,14,10,2021
LA Rams,San Francisco,11/15/2021,Shawn Smith,14,88,5,35,9,53,17,10,2021
New England,Atlanta,11/18/2021,Land Clark,14,131,5,59,9,72,15,11,2021
Indianapolis,Buffalo,11/21/2021,Brad Rogers,10,86,3,30,7,56,14,11,2021
Washington,Carolina,11/21/2021,Bill Vinovich,15,134,8,69,7,65,17,11,2021
Baltimore,Chicago,11/21/2021,Shawn Smith,12,94,6,36,6,58,15,11,2021
Detroit,Cleveland,11/21/2021,Clay Martin,17,149,7,67,10,82,19,11,2021
San Francisco,Jacksonville,11/21/2021,Ron Torbert,9,68,1,12,8,56,13,11,2021
Green Bay,Minnesota,11/21/2021,Shawn Hochuli,11,117,8,92,3,25,11,11,2021
Miami,N.Y. Jets,11/21/2021,Alex Kemp,15,110,8,62,7,48,18,11,2021
New Orleans,Philadelphia,11/21/2021,Scott Novak,9,74,3,25,6,49,11,11,2021
Houston,Tennessee,11/21/2021,Tony Corrente,12,102,7,50,5,52,14,11,2021
Cincinnati,Las Vegas,11/21/2021,Jerome Boger,8,82,1,5,7,77,8,11,2021
Dallas,Kansas City,11/21/2021,John Hussey,12,109,6,45,6,64,14,11,2021
Arizona,Seattle,11/21/2021,Clete Blakeman,5,49,3,32,2,17,10,11,2021
Pittsburgh,LA Chargers,11/21/2021,Carl Cheffers,20,113,8,38,12,75,23,11,2021
N.Y. Giants,Tampa Bay,11/22/2021,Craig Wrolstad,10,69,4,30,6,39,11,11,2021
Chicago,Detroit,11/25/2021,Adrian Hill,15,117,5,50,10,67,19,12,2021
Las Vegas,Dallas,11/25/2021,Shawn Hochuli,28,276,14,110,14,166,33,12,2021
Buffalo,New Orleans,11/25/2021,Brad Allen,8,59,4,35,4,24,9,12,2021
Pittsburgh,Cincinnati,11/28/2021,Bill Vinovich,7,48,4,30,3,18,10,12,2021
N.Y. Jets,Houston,11/28/2021,Clete Blakeman,9,72,5,40,4,32,11,12,2021
Tampa Bay,Indianapolis,11/28/2021,Shawn Smith,10,110,4,44,6,66,12,12,2021
Atlanta,Jacksonville,11/28/2021,Carl Cheffers,11,69,5,26,6,43,13,12,2021
Carolina,Miami,11/28/2021,John Hussey,12,96,7,61,5,35,12,12,2021
Tennessee,New England,11/28/2021,Alex Kemp,9,85,5,50,4,35,10,12,2021
Philadelphia,N.Y. Giants,11/28/2021,Ron Torbert,6,41,4,26,2,15,6,12,2021
LA Chargers,Denver,11/28/2021,Land Clark,14,110,9,75,5,35,15,12,2021
LA Rams,Green Bay,11/28/2021,Craig Wrolstad,7,62,4,30,3,32,12,12,2021
Minnesota,San Francisco,11/28/2021,Brad Rogers,10,95,5,38,5,57,11,12,2021
Cleveland,Baltimore,11/28/2021,Jerome Boger,10,99,5,45,5,54,12,12,2021
Seattle,Washington,11/29/2021,Clay Martin,10,89,6,51,4,38,13,12,2021
Dallas,New Orleans,12/02/2021,Brad Rogers,12,94,5,35,7,59,14,13,2021
Tampa Bay,Atlanta,12/05/2021,Tony Corrente,9,54,3,15,6,39,9,13,2021
Arizona,Chicago,12/05/2021,Jerome Boger,14,108,8,63,6,45,17,13,2021
LA Chargers,Cincinnati,12/05/2021,Shawn Hochuli,14,114,7,51,7,63,17,13,2021
Minnesota,Detroit,12/05/2021,Craig Wrolstad,10,77,7,66,3,11,10,13,2021
Indianapolis,Houston,12/05/2021,Ron Torbert,9,50,5,25,4,25,11,13,2021
Denver,Kansas City,12/05/2021,Carl Cheffers,12,97,5,37,7,60,15,13,2021
N.Y. Giants,Miami,12/05/2021,Brad Allen,6,38,3,23,3,15,8,13,2021
Philadelphia,N.Y. Jets,12/05/2021,Clay Martin,9,86,3,20,6,66,10,13,2021
Washington,Las Vegas,12/05/2021,Adrian Hill,12,101,6,47,6,54,15,13,2021
Jacksonville,LA Rams,12/05/2021,Clete Blakeman,10,86,3,39,7,47,10,13,2021
Baltimore,Pittsburgh,12/05/2021,Scott Novak,15,136,10,55,5,81,17,13,2021
San Francisco,Seattle,12/05/2021,Alex Kemp,16,126,10,86,6,40,16,13,2021
New England,Buffalo,12/06/2021,Bill Vinovich,9,67,6,47,3,20,9,13,2021
Pittsburgh,Minnesota,12/09/2021,Clete Blakeman,21,187,10,85,11,102,23,14,2021
Atlanta,Carolina,12/12/2021,Shawn Smith,12,105,6,60,6,45,12,14,2021
San Francisco,Cincinnati,12/12/2021,Craig Wrolstad,8,59,6,40,2,19,8,14,2021
Baltimore,Cleveland,12/12/2021,Brad Rogers,14,167,10,125,4,42,20,14,2021
Seattle,Houston,12/12/2021,Adrian Hill,14,121,8,69,6,52,16,14,2021
Las Vegas,Kansas City,12/12/2021,Brad Allen,17,148,9,85,8,63,18,14,2021
New Orleans,N.Y. Jets,12/12/2021,Land Clark,9,87,4,42,5,45,9,14,2021
Jacksonville,Tennessee,12/12/2021,Bill Vinovich,11,94,9,79,2,15,13,14,2021
Dallas,Washington,12/12/2021,Alex Kemp,14,125,7,60,7,65,23,14,2021
Detroit,Denver,12/12/2021,John Hussey,8,71,6,53,2,18,12,14,2021
N.Y. Giants,LA Chargers,12/12/2021,Tony Corrente,9,59,3,20,6,39,9,14,2021
Buffalo,Tampa Bay,12/12/2021,Scott Novak,11,89,7,65,4,24,15,14,2021
Chicago,Green Bay,12/12/2021,Ron Torbert,10,71,7,41,3,30,12,14,2021
LA Rams,Arizona,12/13/2021,Carl Cheffers,12,94,5,40,7,54,16,14,2021
Kansas City,LA Chargers,12/16/2021,Shawn Smith,9,96,4,36,5,60,11,15,2021
Carolina,Buffalo,12/19/2021,Clete Blakeman,13,122,5,55,8,67,16,15,2021
Las Vegas,Cleveland,12/20/2021,Craig Wrolstad,10,125,7,64,3,61,11,15,2021
New England,Indianapolis,12/18/2021,Carl Cheffers,10,63,8,50,2,13,15,15,2021
N.Y. Jets,Miami,12/19/2021,Ron Torbert,8,77,3,32,5,45,11,15,2021
Washington,Philadelphia,12/21/2021,Tony Corrente,6,73,2,25,4,48,7,15,2021
Green Bay,Baltimore,12/19/2021,Brad Allen,16,132,8,76,8,56,16,15,2021
Arizona,Detroit,12/19/2021,Land Clark,13,132,7,83,6,49,13,15,2021
Houston,Jacksonville,12/19/2021,Alex Kemp,13,105,9,65,4,40,17,15,2021
Dallas,N.Y. Giants,12/19/2021,Jerome Boger,12,79,6,45,6,34,14,15,2021
Tennessee,Pittsburgh,12/19/2021,Brad Rogers,12,98,7,68,5,30,15,15,2021
Cincinnati,Denver,12/19/2021,Adrian Hill,12,98,6,38,6,60,15,15,2021
Atlanta,San Francisco,12/19/2021,Clay Martin,9,64,4,29,5,35,11,15,2021
Seattle,LA Rams,12/21/2021,Shawn Hochuli,12,99,8,65,4,34,14,15,2021
New Orleans,Tampa Bay,12/19/2021,John Hussey,9,71,6,41,3,30,10,15,2021
Minnesota,Chicago,12/20/2021,Scott Novak,16,145,7,54,9,91,17,15,2021
San Francisco,Tennessee,12/23/2021,Shawn Hochuli,11,98,5,41,6,57,15,16,2021
Cleveland,Green Bay,12/25/2021,Alex Kemp,9,67,6,38,3,29,10,16,2021
Indianapolis,Arizona,12/25/2021,Craig Wrolstad,16,125,5,40,11,85,17,16,2021
Detroit,Atlanta,12/26/2021,Ron Torbert,8,45,6,30,2,15,11,16,2021
Tampa Bay,Carolina,12/26/2021,Brad Allen,12,82,6,50,6,32,15,16,2021
Baltimore,Cincinnati,12/26/2021,Clete Blakeman,11,72,6,27,5,45,15,16,2021
LA Chargers,Houston,12/26/2021,Clay Martin,15,119,5,49,10,70,16,16,2021
LA Rams,Minnesota,12/26/2021,John Hussey,3,25,1,5,2,20,4,16,2021
Buffalo,New England,12/26/2021,Shawn Smith,8,75,5,45,3,30,12,16,2021
Jacksonville,N.Y. Jets,12/26/2021,Tony Corrente,9,104,2,10,7,94,11,16,2021
N.Y. Giants,Philadelphia,12/26/2021,Land Clark,17,119,6,40,11,79,17,16,2021
Chicago,Seattle,12/26/2021,Carl Cheffers,15,161,8,73,7,88,19,16,2021
Pittsburgh,Kansas City,12/26/2021,Jerome Boger,10,81,5,40,5,41,11,16,2021
Denver,Las Vegas,12/26/2021,Scott Novak,6,67,3,30,3,37,7,16,2021
Washington,Dallas,12/26/2021,Bill Vinovich,4,28,1,13,3,15,7,16,2021
Miami,New Orleans,12/27/2021,Adrian Hill,14,127,7,65,7,62,17,16,2021
Atlanta,Buffalo,01/02/2022,Land Clark,11,74,4,27,7,47,15,17,2021
N.Y. Giants,Chicago,01/02/2022,Shawn Hochuli,8,61,3,26,5,35,8,17,2021
Kansas City,Cincinnati,01/02/2022,Ron Torbert,15,145,10,83,5,62,19,17,2021
Arizona,Dallas,01/02/2022,Scott Novak,17,133,7,45,10,88,19,17,2021
Las Vegas,Indianapolis,01/02/2022,Brad Rogers,9,66,6,41,3,25,11,17,2021
Jacksonville,New England,01/02/2022,Adrian Hill,6,55,3,25,3,30,7,17,2021
Carolina,New Orleans,01/02/2022,Jerome Boger,6,38,1,5,5,33,8,17,2021
Tampa Bay,N.Y. Jets,01/02/2022,Alex Kemp,6,53,4,39,2,14,11,17,2021
Miami,Tennessee,01/02/2022,Shawn Smith,11,125,5,55,6,70,14,17,2021
Philadelphia,Washington,01/02/2022,Clete Blakeman,7,46,6,42,1,4,7,17,2021
Denver,LA Chargers,01/02/2022,Craig Wrolstad,6,45,3,23,3,22,10,17,2021
Houston,San Francisco,01/02/2022,Carl Cheffers,12,178,5,67,7,111,15,17,2021
LA Rams,Baltimore,01/02/2022,Bill Vinovich,8,59,4,35,4,24,8,17,2021
Detroit,Seattle,01/02/2022,Tony Corrente,9,61,4,30,5,31,11,17,2021
Minnesota,Green Bay,01/02/2022,Clay Martin,4,28,3,23,1,5,6,17,2021
Cleveland,Pittsburgh,01/03/2022,Brad Allen,15,128,10,77,5,51,19,17,2021
Buffalo,LA Rams,09/08/2022,Carl Cheffers,9,65,5,35,4,30,9,1,2022
New Orleans,Atlanta,09/11/2022,Alex Kemp,16,154,8,99,8,55,19,1,2022
Cleveland,Carolina,09/11/2022,Brad Rogers,17,167,9,71,8,96,17,1,2022
San Francisco,Chicago,09/11/2022,Clay Martin,15,123,12,99,3,24,17,1,2022
Pittsburgh,Cincinnati,09/11/2022,Shawn Hochuli,12,86,8,59,4,27,14,1,2022
Philadelphia,Detroit,09/11/2022,Brad Allen,17,126,10,61,7,65,20,1,2022
Indianapolis,Houston,09/11/2022,Land Clark,13,129,7,89,6,40,15,1,2022
New England,Miami,09/11/2022,John Hussey,7,35,3,15,4,20,10,1,2022
Baltimore,N.Y. Jets,09/11/2022,Craig Wrolstad,11,110,5,29,6,81,11,1,2022
Jacksonville,Washington,09/11/2022,Tra Blake,19,153,13,90,6,63,21,1,2022
Kansas City,Arizona,09/11/2022,Scott Novak,8,74,3,25,5,49,10,1,2022
Las Vegas,LA Chargers,09/11/2022,Shawn Smith,8,32,3,11,5,21,9,1,2022
Green Bay,Minnesota,09/11/2022,Bill Vinovich,5,30,2,10,3,20,8,1,2022
N.Y. Giants,Tennessee,09/11/2022,Jerome Boger,15,95,8,45,7,50,16,1,2022
Tampa Bay,Dallas,09/11/2022,Ron Torbert,15,98,5,25,10,73,15,1,2022
Denver,Seattle,09/12/2022,Clete Blakeman,17,183,12,106,5,77,18,1,2022
LA Chargers,Kansas City,09/15/2022,John Hussey,9,79,3,25,6,54,14,2,2022
Miami,Baltimore,09/18/2022,Adrian Hill,9,56,8,51,1,5,13,2,2022
N.Y. Jets,Cleveland,09/18/2022,Tra Blake,13,95,8,57,5,38,15,2,2022
Washington,Detroit,09/18/2022,Bill Vinovich,3,22,2,17,1,5,5,2,2022
Indianapolis,Jacksonville,09/18/2022,Alex Kemp,8,49,5,30,3,19,13,2,2022
Tampa Bay,New Orleans,09/18/2022,Shawn Hochuli,17,161,8,101,9,60,19,2,2022
Carolina,N.Y. Giants,09/18/2022,Ron Torbert,13,100,5,38,8,62,15,2,2022
New England,Pittsburgh,09/18/2022,Land Clark,10,75,7,55,3,20,11,2,2022
Atlanta,LA Rams,09/18/2022,Clay Martin,8,90,5,29,3,61,9,2,2022
Seattle,San Francisco,09/18/2022,Brad Rogers,11,132,10,106,1,26,13,2,2022
Cincinnati,Dallas,09/18/2022,Brad Allen,12,80,7,35,5,45,16,2,2022
Houston,Denver,09/18/2022,Carl Cheffers,21,194,8,94,13,100,25,2,2022
Arizona,Las Vegas,09/18/2022,Clete Blakeman,22,188,12,120,10,68,24,2,2022
Chicago,Green Bay,09/18/2022,Craig Wrolstad,10,75,7,50,3,25,12,2,2022
Tennessee,Buffalo,09/19/2022,Shawn Smith,17,136,9,87,8,49,21,2,2022
Minnesota,Philadelphia,09/19/2022,Scott Novak,13,85,5,25,8,60,15,2,2022
Pittsburgh,Cleveland,09/22/2022,Clay Martin,10,49,5,25,5,24,14,3,2022
New Orleans,Carolina,09/25/2022,Carl Cheffers,11,98,7,58,4,40,14,3,2022
Houston,Chicago,09/25/2022,Clete Blakeman,9,57,3,25,6,32,12,3,2022
Kansas City,Indianapolis,09/25/2022,Shawn Smith,10,79,6,45,4,34,12,3,2022
Buffalo,Miami,09/25/2022,Alex Kemp,11,72,7,52,4,20,14,3,2022
Detroit,Minnesota,09/25/2022,John Hussey,10,74,7,59,3,15,13,3,2022
Baltimore,New England,09/25/2022,Bill Vinovich,5,26,2,10,3,16,7,3,2022
Cincinnati,N.Y. Jets,09/25/2022,Jerome Boger,9,85,5,30,4,55,11,3,2022
Las Vegas,Tennessee,09/25/2022,Brad Rogers,13,129,6,44,7,85,16,3,2022
Philadelphia,Washington,09/25/2022,Ron Torbert,9,100,5,52,4,48,10,3,2022
Jacksonville,LA Chargers,09/25/2022,Craig Wrolstad,9,64,2,10,7,54,11,3,2022
LA Rams,Arizona,09/25/2022,Adrian Hill,12,85,6,35,6,50,13,3,2022
Atlanta,Seattle,09/25/2022,Tra Blake,8,62,2,15,6,47,10,3,2022
Green Bay,Tampa Bay,09/25/2022,Scott Novak,14,105,8,65,6,40,15,3,2022
San Francisco,Denver,09/25/2022,Shawn Hochuli,12,70,7,40,5,30,14,3,2022
Dallas,N.Y. Giants,09/26/2022,Land Clark,16,127,8,70,8,57,21,3,2022
Miami,Cincinnati,09/29/2022,Tra Blake,12,115,6,41,6,74,15,4,2022
Minnesota,New Orleans,10/02/2022,Clete Blakeman,15,137,5,35,10,102,17,4,2022
Cleveland,Atlanta,10/02/2022,Craig Wrolstad,8,66,7,51,1,15,11,4,2022
Buffalo,Baltimore,10/02/2022,Jerome Boger,13,101,4,31,9,70,15,4,2022
Washington,Dallas,10/02/2022,Shawn Smith,15,156,11,136,4,20,16,4,2022
Seattle,Detroit,10/02/2022,Clay Martin,19,135,11,76,8,59,24,4,2022
LA Chargers,Houston,10/02/2022,Alex Kemp,15,128,6,61,9,67,19,4,2022
Tennessee,Indianapolis,10/02/2022,Scott Novak,13,90,6,40,7,50,16,4,2022
Chicago,N.Y. Giants,10/02/2022,Carl Cheffers,12,120,5,65,7,55,14,4,2022
Jacksonville,Philadelphia,10/02/2022,Shawn Hochuli,7,58,4,38,3,20,11,4,2022
N.Y. Jets,Pittsburgh,10/02/2022,Brad Rogers,15,119,7,64,8,55,17,4,2022
Arizona,Carolina,10/02/2022,John Hussey,13,137,7,61,6,76,16,4,2022
New England,Green Bay,10/02/2022,Adrian Hill,11,115,7,75,4,40,13,4,2022
Denver,Las Vegas,10/02/2022,Land Clark,11,75,7,50,4,25,14,4,2022
Kansas City,Tampa Bay,10/02/2022,Bill Vinovich,9,72,4,32,5,40,11,4,2022
LA Rams,San Francisco,10/03/2022,Brad Allen,5,30,1,5,4,25,5,4,2022
Indianapolis,Denver,10/06/2022,Brad Rogers,15,113,8,64,7,49,17,5,2022
N.Y. Giants,Green Bay,10/09/2022,Alex Kemp,13,100,6,63,7,37,14,5,2022
Pittsburgh,Buffalo,10/09/2022,John Hussey,11,82,6,54,5,28,14,5,2022
LA Chargers,Cleveland,10/09/2022,Adrian Hill,10,82,4,17,6,65,13,5,2022
Houston,Jacksonville,10/09/2022,Ron Torbert,10,73,4,25,6,48,13,5,2022
Chicago,Minnesota,10/09/2022,Shawn Hochuli,13,110,6,40,7,70,15,5,2022
Detroit,New England,10/09/2022,Craig Wrolstad,13,128,7,82,6,46,14,5,2022
Seattle,New Orleans,10/09/2022,Brad Allen,18,142,12,85,6,57,21,5,2022
Miami,N.Y. Jets,10/09/2022,Clay Martin,16,207,11,102,5,105,17,5,2022
Atlanta,Tampa Bay,10/09/2022,Jerome Boger,12,100,6,55,6,45,12,5,2022
Tennessee,Washington,10/09/2022,Land Clark,17,140,8,69,9,71,20,5,2022
San Francisco,Carolina,10/09/2022,Shawn Smith,14,83,9,50,5,33,16,5,2022
Philadelphia,Arizona,10/09/2022,Tra Blake,5,45,3,30,2,15,5,5,2022
Dallas,LA Rams,10/09/2022,Bill Vinovich,8,67,5,42,3,25,11,5,2022
Cincinnati,Baltimore,10/09/2022,Scott Novak,10,68,4,20,6,48,11,5,2022
Las Vegas,Kansas City,10/10/2022,Carl Cheffers,16,171,11,99,5,72,18,5,2022
Washington,Chicago,10/13/2022,Adrian Hill,11,78,7,36,4,42,12,6,2022
San Francisco,Atlanta,10/16/2022,Carl Cheffers,10,70,5,30,5,40,10,6,2022
New England,Cleveland,10/16/2022,Scott Novak,19,155,12,92,7,63,19,6,2022
N.Y. Jets,Green Bay,10/16/2022,Clete Blakeman,14,121,7,79,7,42,16,6,2022
Jacksonville,Indianapolis,10/16/2022,Jerome Boger,11,96,4,44,7,52,11,6,2022
Minnesota,Miami,10/16/2022,Brad Rogers,12,117,2,20,10,97,13,6,2022
Cincinnati,New Orleans,10/16/2022,Land Clark,7,64,3,30,4,34,8,6,2022
Baltimore,N.Y. Giants,10/16/2022,Clay Martin,13,99,10,74,3,25,14,6,2022
Tampa Bay,Pittsburgh,10/16/2022,Shawn Smith,13,87,6,42,7,45,17,6,2022
Carolina,LA Rams,10/16/2022,Tra Blake,10,79,3,30,7,49,13,6,2022
Arizona,Seattle,10/16/2022,Shawn Hochuli,12,97,6,53,6,44,15,6,2022
Buffalo,Kansas City,10/16/2022,Brad Allen,12,93,7,35,5,58,16,6,2022
Dallas,Philadelphia,10/16/2022,John Hussey,12,82,10,72,2,10,14,6,2022
Denver,LA Chargers,10/17/2022,Ron Torbert,19,240,10,151,9,89,19,6,2022
New Orleans,Arizona,10/20/2022,Jerome Boger,12,69,8,49,4,20,14,7,2022
Cleveland,Baltimore,10/23/2022,Shawn Smith,9,98,6,45,3,53,10,7,2022
Tampa Bay,Carolina,10/23/2022,Craig Wrolstad,7,45,4,30,3,15,9,7,2022
Atlanta,Cincinnati,10/23/2022,Clete Blakeman,8,39,3,22,5,17,11,7,2022
Detroit,Dallas,10/23/2022,Adrian Hill,15,114,8,59,7,55,16,7,2022
N.Y. Giants,Jacksonville,10/23/2022,Tra Blake,21,148,8,67,13,81,23,7,2022
Indianapolis,Tennessee,10/23/2022,Ron Torbert,6,43,4,28,2,15,9,7,2022
Green Bay,Washington,10/23/2022,Clay Martin,16,123,9,69,7,54,20,7,2022
N.Y. Jets,Denver,10/23/2022,Bill Vinovich,15,119,11,85,4,34,16,7,2022
Houston,Las Vegas,10/23/2022,John Hussey,8,58,3,14,5,44,8,7,2022
Seattle,LA Chargers,10/23/2022,Land Clark,14,138,7,68,7,70,16,7,2022
Kansas City,San Francisco,10/23/2022,Alex Kemp,18,164,8,84,10,80,26,7,2022
Pittsburgh,Miami,10/23/2022,Scott Novak,10,70,5,40,5,30,10,7,2022
Chicago,New England,10/24/2022,Brad Allen,8,65,4,35,4,30,12,7,2022
Baltimore,Tampa Bay,10/27/2022,Carl Cheffers,11,136,7,101,4,35,13,8,2022
Denver,Jacksonville,10/30/2022,Adrian Hill,17,135,12,81,5,54,18,8,2022
Carolina,Atlanta,10/30/2022,Shawn Hochuli,16,138,9,74,7,64,19,8,2022
Chicago,Dallas,10/30/2022,Brad Rogers,12,86,6,45,6,41,13,8,2022
Miami,Detroit,10/30/2022,Alex Kemp,13,85,7,55,6,30,24,8,2022
Arizona,Minnesota,10/30/2022,Brad Allen,20,153,10,67,10,86,24,8,2022
Las Vegas,New Orleans,10/30/2022,Scott Novak,11,86,6,59,5,27,11,8,2022
New England,N.Y. Jets,10/30/2022,Shawn Smith,10,95,6,54,4,41,11,8,2022
Pittsburgh,Philadelphia,10/30/2022,Clete Blakeman,17,120,9,60,8,60,17,8,2022
Tennessee,Houston,10/30/2022,Clay Martin,12,80,6,35,6,45,14,8,2022
Washington,Indianapolis,10/30/2022,Craig Wrolstad,6,77,3,52,3,25,6,8,2022
San Francisco,LA Rams,10/30/2022,John Hussey,7,58,3,8,4,50,8,8,2022
N.Y. Giants,Seattle,10/30/2022,Jerome Boger,9,78,6,53,3,25,9,8,2022
Green Bay,Buffalo,10/30/2022,Ron Torbert,12,93,8,58,4,35,13,8,2022
Cincinnati,Cleveland,10/31/2022,Bill Vinovich,8,62,2,6,6,56,9,8,2022
Philadelphia,Houston,11/03/2022,Craig Wrolstad,8,59,4,31,4,28,9,9,2022
LA Chargers,Atlanta,11/06/2022,John Hussey,7,60,5,45,2,15,9,9,2022
Miami,Chicago,11/06/2022,Ron Torbert,7,130,3,38,4,92,10,9,2022
Carolina,Cincinnati,11/06/2022,Alex Kemp,12,85,7,50,5,35,18,9,2022
Green Bay,Detroit,11/06/2022,Tra Blake,15,143,8,81,7,62,15,9,2022
Las Vegas,Jacksonville,11/06/2022,Bill Vinovich,9,75,5,45,4,30,12,9,2022
Indianapolis,New England,11/06/2022,Clay Martin,6,50,2,15,4,35,8,9,2022
Buffalo,N.Y. Jets,11/06/2022,Land Clark,6,60,3,30,3,30,6,9,2022
Minnesota,Washington,11/06/2022,Jerome Boger,8,68,5,42,3,26,8,9,2022
Seattle,Arizona,11/06/2022,Carl Cheffers,18,111,6,34,12,77,19,9,2022
LA Rams,Tampa Bay,11/06/2022,Shawn Hochuli,11,108,4,53,7,55,13,9,2022
Tennessee,Kansas City,11/06/2022,Clete Blakeman,18,120,8,51,10,69,24,9,2022
Baltimore,New Orleans,11/07/2022,Brad Rogers,10,71,5,31,5,40,10,9,2022
Atlanta,Carolina,11/10/2022,Adrian Hill,14,126,4,37,10,89,18,10,2022
Seattle,Tampa Bay,11/13/2022,John Hussey,10,86,6,46,4,40,10,10,2022
Minnesota,Buffalo,11/13/2022,Craig Wrolstad,14,128,7,64,7,64,15,10,2022
Detroit,Chicago,11/13/2022,Land Clark,11,101,2,15,9,86,12,10,2022
Jacksonville,Kansas City,11/13/2022,Brad Rogers,5,30,5,30,0,0,6,10,2022
Cleveland,Miami,11/13/2022,Shawn Hochuli,11,95,6,52,5,43,13,10,2022
Houston,N.Y. Giants,11/13/2022,Bill Vinovich,12,64,7,40,5,24,18,10,2022
New Orleans,Pittsburgh,11/13/2022,Carl Cheffers,13,114,10,74,3,40,14,10,2022
Denver,Tennessee,11/13/2022,Scott Novak,17,110,8,50,9,60,19,10,2022
Indianapolis,Las Vegas,11/13/2022,Tra Blake,14,99,4,25,10,74,17,10,2022
Dallas,Green Bay,11/13/2022,Brad Allen,15,123,9,83,6,40,20,10,2022
Arizona,LA Rams,11/13/2022,Clete Blakeman,15,96,10,67,5,29,15,10,2022
LA Chargers,San Francisco,11/13/2022,Shawn Smith,6,57,1,5,5,52,10,10,2022
Washington,Philadelphia,11/14/2022,Alex Kemp,12,133,5,58,7,75,13,10,2022
Tennessee,Green Bay,11/17/2022,Bill Vinovich,7,60,2,20,5,40,8,11,2022
Chicago,Atlanta,11/20/2022,Tra Blake,9,69,7,56,2,13,11,11,2022
Carolina,Baltimore,11/20/2022,Jerome Boger,19,159,9,66,10,93,20,11,2022
Cleveland,Buffalo,11/20/2022,Adrian Hill,14,131,6,42,8,89,18,11,2022
Washington,Houston,11/20/2022,Scott Novak,7,51,5,36,2,15,12,11,2022
Philadelphia,Indianapolis,11/20/2022,Land Clark,15,145,7,55,8,90,15,11,2022
N.Y. Jets,New England,11/20/2022,Carl Cheffers,11,70,3,15,8,55,14,11,2022
LA Rams,New Orleans,11/20/2022,Ron Torbert,8,70,6,55,2,15,8,11,2022
Detroit,N.Y. Giants,11/20/2022,Brad Rogers,13,108,5,45,8,63,15,11,2022
Las Vegas,Denver,11/20/2022,Shawn Smith,14,143,9,98,5,45,16,11,2022
Kansas City,LA Chargers,11/20/2022,Shawn Hochuli,8,79,4,54,4,25,9,11,2022
Dallas,Minnesota,11/20/2022,Clay Martin,13,98,6,39,7,59,15,11,2022
Cincinnati,Pittsburgh,11/20/2022,Brad Allen,14,114,6,44,8,70,14,11,2022
San Francisco,Arizona,11/21/2022,Craig Wrolstad,8,80,3,30,5,50,11,11,2022
Buffalo,Detroit,11/24/2022,Clete Blakeman,8,68,5,36,3,32,10,12,2022
N.Y. Giants,Dallas,11/24/2022,Scott Novak,20,152,7,66,13,86,22,12,2022
New England,Minnesota,11/24/2022,Alex Kemp,9,75,6,55,3,20,9,12,2022
Denver,Carolina,11/27/2022,Clay Martin,8,78,4,44,4,34,11,12,2022
Tampa Bay,Cleveland,11/27/2022,Tra Blake,14,112,9,70,5,42,17,12,2022
Baltimore,Jacksonville,11/27/2022,Land Clark,7,39,3,20,4,19,9,12,2022
Houston,Miami,11/27/2022,Jerome Boger,9,80,5,45,4,35,9,12,2022
Chicago,N.Y. Jets,11/27/2022,John Hussey,2,15,1,10,1,5,7,12,2022
Cincinnati,Tennessee,11/27/2022,Carl Cheffers,17,137,9,80,8,57,18,12,2022
Atlanta,Washington,11/27/2022,Brad Rogers,6,48,2,20,4,28,7,12,2022
LA Chargers,Arizona,11/27/2022,Ron Torbert,7,49,4,30,3,19,10,12,2022
Las Vegas,Seattle,11/27/2022,Brad Allen,9,60,7,50,2,10,9,12,2022
LA Rams,Kansas City,11/27/2022,Adrian Hill,8,50,5,25,3,25,8,12,2022
New Orleans,San Francisco,11/27/2022,Shawn Hochuli,13,110,6,46,7,64,18,12,2022
Green Bay,Philadelphia,11/27/2022,Shawn Smith,7,60,4,35,3,25,9,12,2022
Pittsburgh,Indianapolis,11/28/2022,Bill Vinovich,5,39,3,19,2,20,9,12,2022
Buffalo,New England,12/01/2022,Shawn Hochuli,12,109,6,47,6,62,16,13,2022
Pittsburgh,Atlanta,12/04/2022,Ron Torbert,13,78,7,30,6,48,15,13,2022
Denver,Baltimore,12/04/2022,Alex Kemp,7,63,4,48,3,15,8,13,2022
Green Bay,Chicago,12/04/2022,Scott Novak,7,83,2,20,5,63,8,13,2022
Jacksonville,Detroit,12/04/2022,Jerome Boger,6,34,5,24,1,10,6,13,2022
Cleveland,Houston,12/04/2022,Land Clark,11,87,6,56,5,31,15,13,2022
N.Y. Jets,Minnesota,12/04/2022,Clete Blakeman,9,84,6,40,3,44,10,13,2022
Washington,N.Y. Giants,12/04/2022,Brad Allen,11,90,7,56,4,34,13,13,2022
Tennessee,Philadelphia,12/04/2022,Adrian Hill,19,162,7,82,12,80,24,13,2022
Seattle,LA Rams,12/04/2022,Shawn Smith,10,81,6,42,4,39,11,13,2022
Miami,San Francisco,12/04/2022,Tra Blake,12,113,8,68,4,45,13,13,2022
Kansas City,Cincinnati,12/04/2022,John Hussey,10,100,4,35,6,65,12,13,2022
LA Chargers,Las Vegas,12/04/2022,Craig Wrolstad,7,35,4,20,3,15,8,13,2022
Indianapolis,Dallas,12/04/2022,Carl Cheffers,9,131,6,88,3,43,11,13,2022
New Orleans,Tampa Bay,12/05/2022,Clay Martin,10,123,6,84,4,39,11,13,2022
Las Vegas,LA Rams,12/08/2022,Brad Rogers,14,154,7,94,7,60,21,14,2022
N.Y. Jets,Buffalo,12/11/2022,Alex Kemp,12,96,7,61,5,35,15,14,2022
Cleveland,Cincinnati,12/11/2022,Jerome Boger,13,134,9,98,4,36,19,14,2022
Houston,Dallas,12/11/2022,John Hussey,7,35,4,25,3,10,11,14,2022
Minnesota,Detroit,12/11/2022,Ron Torbert,10,76,3,25,7,51,10,14,2022
Philadelphia,N.Y. Giants,12/11/2022,Clete Blakeman,7,43,2,9,5,34,9,14,2022
Baltimore,Pittsburgh,12/11/2022,Adrian Hill,7,61,5,46,2,15,10,14,2022
Jacksonville,Tennessee,12/11/2022,Clay Martin,14,120,9,70,5,50,18,14,2022
Miami,LA Chargers,12/11/2022,Scott Novak,12,90,6,50,6,40,14,14,2022
Carolina,Seattle,12/11/2022,Bill Vinovich,9,64,6,29,3,35,11,14,2022
Tampa Bay,San Francisco,12/11/2022,Brad Allen,10,77,8,62,2,15,11,14,2022
Kansas City,Denver,12/11/2022,Craig Wrolstad,10,108,4,70,6,38,10,14,2022
New England,Arizona,12/12/2022,Shawn Smith,16,128,8,80,8,48,20,14,2022
San Francisco,Seattle,12/15/2022,Alex Kemp,15,139,7,60,8,79,19,15,2022
Miami,Buffalo,12/17/2022,Bill Vinovich,15,102,8,51,7,51,21,15,2022
Baltimore,Cleveland,12/17/2022,Brad Allen,6,57,3,25,3,32,10,15,2022
Indianapolis,Minnesota,12/17/2022,Tra Blake,20,177,11,103,9,74,20,15,2022
Atlanta,New Orleans,12/18/2022,Clete Blakeman,9,76,3,30,6,46,11,15,2022
N.Y. Giants,Washington,12/18/2022,John Hussey,11,70,5,30,6,40,11,15,2022
Pittsburgh,Carolina,12/18/2022,Scott Novak,12,121,7,81,5,40,14,15,2022
Philadelphia,Chicago,12/18/2022,Brad Rogers,8,55,2,25,6,30,11,15,2022
Kansas City,Houston,12/18/2022,Carl Cheffers,14,135,10,102,4,33,17,15,2022
Dallas,Jacksonville,12/18/2022,Shawn Smith,6,55,2,18,4,37,7,15,2022
Detroit,N.Y. Jets,12/18/2022,Craig Wrolstad,8,72,6,52,2,20,14,15,2022
Arizona,Denver,12/18/2022,Jerome Boger,11,77,7,46,4,31,11,15,2022
Tennessee,LA Chargers,12/18/2022,Land Clark,9,82,6,62,3,20,13,15,2022
Cincinnati,Tampa Bay,12/18/2022,Adrian Hill,11,85,4,27,7,58,12,15,2022
New England,Las Vegas,12/18/2022,Ron Torbert,19,120,6,30,13,90,19,15,2022
LA Rams,Green Bay,12/19/2022,Shawn Hochuli,12,156,8,76,4,80,16,15,2022
Jacksonville,N.Y. Jets,12/22/2022,Brad Allen,12,89,3,25,9,64,14,16,2022
Atlanta,Baltimore,12/24/2022,Bill Vinovich,6,54,5,48,1,6,7,16,2022
Detroit,Carolina,12/24/2022,Shawn Hochuli,14,104,4,30,10,74,17,16,2022
Buffalo,Chicago,12/24/2022,Carl Cheffers,11,87,9,72,2,15,11,16,2022
New Orleans,Cleveland,12/24/2022,Brad Rogers,6,60,2,15,4,45,7,16,2022
Seattle,Kansas City,12/24/2022,Clete Blakeman,11,74,6,35,5,39,13,16,2022
N.Y. Giants,Minnesota,12/24/2022,Adrian Hill,9,77,7,63,2,14,9,16,2022
Cincinnati,New England,12/24/2022,Craig Wrolstad,18,144,8,62,10,82,19,16,2022
Houston,Tennessee,12/24/2022,Shawn Smith,9,65,4,35,5,30,13,16,2022
Washington,San Francisco,12/24/2022,Jerome Boger,10,76,6,51,4,25,13,16,2022
Philadelphia,Dallas,12/24/2022,Alex Kemp,6,46,2,10,4,36,10,16,2022
Las Vegas,Pittsburgh,12/24/2022,Tra Blake,5,55,2,20,3,35,5,16,2022
Green Bay,Miami,12/25/2022,Land Clark,13,102,5,40,8,62,13,16,2022
Denver,LA Rams,12/25/2022,Ron Torbert,9,61,6,55,3,6,9,16,2022
Tampa Bay,Arizona,12/25/2022,John Hussey,11,104,5,30,6,74,13,16,2022
LA Chargers,Indianapolis,12/26/2022,Clay Martin,8,71,6,60,2,11,8,16,2022
Dallas,Tennessee,12/29/2022,Shawn Hochuli,13,159,3,35,10,124,15,17,2022
Arizona,Atlanta,01/01/2023,Alex Kemp,13,120,8,50,5,70,14,17,2022
Pittsburgh,Baltimore,01/01/2023,Land Clark,10,73,6,43,4,30,11,17,2022
Chicago,Detroit,01/01/2023,Adrian Hill,9,91,3,49,6,42,11,17,2022
Jacksonville,Houston,01/01/2023,Scott Novak,9,75,2,30,7,45,10,17,2022
Denver,Kansas City,01/01/2023,Tra Blake,8,54,3,23,5,31,9,17,2022
Miami,New England,01/01/2023,Brad Allen,15,110,9,71,6,39,15,17,2022
Indianapolis,N.Y. Giants,01/01/2023,Craig Wrolstad,10,80,7,60,3,20,10,17,2022
New Orleans,Philadelphia,01/01/2023,Jerome Boger,11,69,3,20,8,49,11,17,2022
Carolina,Tampa Bay,01/01/2023,Brad Rogers,16,109,8,58,8,51,17,17,2022
Cleveland,Washington,01/01/2023,Bill Vinovich,8,44,3,20,5,24,11,17,2022
San Francisco,Las Vegas,01/01/2023,Clay Martin,15,120,9,71,6,49,16,17,2022
N.Y. Jets,Seattle,01/01/2023,Ron Torbert,7,35,2,10,5,25,7,17,2022
Minnesota,Green Bay,01/01/2023,Carl Cheffers,9,65,6,35,3,30,11,17,2022
LA Rams,LA Chargers,01/01/2023,Clete Blakeman,5,41,3,22,2,19,9,17,2022
